hai	hey
aku	I
ya	yes
ini	this
oke	OK
yang	that ~, which ~, the one
udah	finished
itu	that, those
nggak	no (Jakarta slang)
ada	there is, there are
di	in, at, upon
sih	(particle used to soften questions)
bisa	can, be able to
kita	(inclusive) we
enggak	no (Jakarta slang)
kamu	you (informal)
mau	want, wish
kalau	if
lagi	again
apa	what, which
nih	this one
aja	just
gitu	I see
tuh	it, that, those (informal)
kalian	you guys
iya	yeah
jadi	become, so, finished
banget	very, extremely
kayak	like, as if
ke	to, towards
juga	Also, too, even if, anyway
dulu	previously, before
deh	Idiolect (Jakarta)
gimana	How
kan	Idiolect, would, shortened form of akan
tapi	but
tadi	Earlier, a while ago
nah	Well!, here!, see now!
sini	Here
tahu	Know
mana	where, which, how
dari	from, out of, starting from or at, than
jangan	do not, should not
terus	direct, straight, immediately, continue, keep on, next, then
aduh	ouch!, ow!
kok	Idiolect, shuttlecock, bird, birdie, shuttle
dan	and
kau	you, thee, thou
kenapa	why
sama	same, equal
ayo	let's go, come on
tidak	not, non
nanti	later, presently
harus	have to, must
bukan	not, no (with nouns, pronouns)
kasih	love, affection
pakai	by means of, with, wear
masih	still, yet
dia	she, her, he, him
semua	all
belum	not yet
halo	hello
punya	have, possess
saya	I
yo	yo
coba	try
nya	her, his, its (suffix)
hehehe	laughing sound
satu	one
karena	because, since
dong	(A mild way of emphasizing something, used at the end of a sentence)
gak	no
bikin	cause, make
mati	be dead, die, go out, stop, fixed
siapa	who, whose, whom
lebih	more, more than
ngomong	talk, say
buat	do, make, create
untuk	for, on behalf of, in order to
atau	or
sudah	already, past, last, all right
banyak	many, a lot of, much
orang	person, one, people in general
boleh	may, can, be able
makasih	thanks
lihat	see, refer to
sekarang	now, nowadays
emang	indeed
sampai	until, till, as far as, arrive
loh	you (Jakarta slang), loh can also mean similar to 'huh?'
lah	(suggesting action, showing agreement, suffix)
mungkin	possible
makan	eat
cuma	merely, only, but
hah	huh
suka	like, be fond of, joy, pleasure
kali	time
terima	acceptance of
butuh	need
gini	"like this, (""gini caranya"") here is how"
maaf	sorry, excuse, forgive, pardon, ask permission to leave
salah	fault, mistake, wrong
dengan	with, by, using
ni	nickel, ni, atomic number 28
baru	new, recent, only then, not until, to be about to
apa-apa	what's the matter?
soalnya	the thing is ~
akan	will, about to, about, regarding
bentar	just a moment
kayaknya	maybe
hari	day
biar	let, permit, so that, although
sekali	very, absolutely
gila	crazy
ngasih	give
paling	the most
langsung	direct, straight, immediately
indonesia	Indonesia
doang	only
pernah	ever, once
mereka	their, them, they
habis	finished, end, after that, then, completely, entirely
om	uncle
disini	here
tidur	sleep, go to sleep
memang	you're right, that's true, indeed
namanya	her/his name (nama with -nya)
keren	cool
naik	climb, go up, ride
ngapain	what are you doing
tak	no, not
yah	(Idiolect) similar to oh well
bagus	beautiful, fine
pasti	certain, definite, confirm, decide
pengen	want to
begitu	like that, so, very, as soon as
atas	on, top, up
yuk	come on, let's go
sangat	very
balik	turn around
baca	read
semuanya	of it/them all
sendiri	own, by yourself
maksudnya	it means
hei	hey
dua	two
ambil	to take
woi	"Woi ""used when calling someone you are familiar"""
wah	Wow, Expression of amazement
gue	I
lupa	Forget
tolong	help, please
sabar	calm, patient
susah	difficult
tunggu	Wait
air	Water, liquid, juice
enak	Delicious, tasty, well, nice, pleasant, at ease, comfortable
bener	right, true
jam	Hour, o'clock, time for doing, watch
pada	At, on, in
usah	"combine with ""gak usah"" that means ""don't"""
udahlah	never mind
masuk	enter
lain	Another, other, different, not including
ia	he, she
misalnya	for example
sebenarnya	actually
bawah	below, under
si	(Definite article used with names or nicknames)
just	Just
saja	Only, just, nothing else than, exactly
bilang	Say
ngerti	understand
lu	You
situ	there
katanya	he said
nama	name
dah	done, bye
minum	Drink
berarti	means
waduh	Oh no
rumah	House
makanya	Consequently, because of that, no wonder!
baik	good
besok	Tomorrow
depan	front
ntar	later
mulai	start
berapa	how many, how much
jalan	street, road
pas	Be the right size, exactly, document, pass
adalah	is
waktu	time
teh	tea, can also means calling older woman (Sundanese)
nonton	watch
hanya	Just, only, however
pokoknya	the main thing is
biasa	normal
lucu	funny
tinggal	Live, stay, remain, be left
kobo	Kobo
pak	Sir
cara	Manner, method, way, fashion, style
semangat	Enthusiasm, spirit, morale, zest
mbak	older woman titles (Javanese)
kemana	where to
takut	Be afraid
betul	Correct, right, true, really, very
serius	serious
selesai	done
bakal	will
ayah	Father
oleh	by
cukup	Enough, sufficient, quite
bingung	Bewildered, confused, panicky
suara	voice
cepet	fast
harusnya	Should be
mah	"Calling mom, ""ini mah"" this is just"
cepat	fast
sakit	sick
dalam	in, inside
kayla	Kayla.
bu	Miss
kah	"Idiolect, says to confirm things, ""ini kah?"" is this it ?"
sana	there
kiri	left
apaan	what (annoyed)
bahasa	Language
ternyata	it turns out
jatuh	fall
kurang	not enough
benar	correct
seperti	as
kecil	small
gede	Big
siap	ready
lanjut	carry on
perlu	need
ikan	Fish, meat
dapat	could
keluar	go out
tempat	the place
buka	open
begini	like this
cat	Paint
dimana	where
hilang	is lost
mundur	Retreat
apakah	is
cari	search
turun	down
neng	Calling younger woman
beneran	It's true
beli	buy
kemarin	yesterday
kak	Older sister or brother
akhirnya	Eventually
mami	Mommy
anda	You, your, yours
bohong	To lie, to tell a lie
belakang	behind
semoga	hopefully
merah	red
menjadi	Becomes
lama	long time
terlalu	too
masa	Period
malam	nocturnal
ndak	not
santai	relaxed
warna	color
tiga	three
jauh	far
cuman	Only
hihihi	Hihihi
gua	Me, I, cave
hidup	life
sebentar	a moment
penting	important
tenang	calm
kanan	right
pagi	morning
tengah	middle
tetap	permanent
lewat	pass, through
na	sodium, na, atomic number 11
pergi	go
lalu	then
ketemu	meet
aneh	strange
datang	come
saat	moment, while
selalu	always
tet	Tet.
udah-udah	Already, done
huhuhu	Hu Hu Hu
caranya	the method
allah	God
hujan	rain
pun	even (suffix)
anak	child
kata	say
kapan	when
kami	(exclusive) we
astaga	good grief
luar	outside, beyond
bangun	wake up
nanya	asking
cerita	story
senpai	Senpai
kesini	get over here
aman	safe
sambil	while
pulau	Island
donasinya	donation
biasanya	usually
setelah	after
kokh	TYPO, Firm, solid, strong
sering	often
ganti	change
ngetik	Typing
dragon	dragoon
tinggi	tall
bisa-bisa	can
taruh	put
bawa	bring
disitu	There.
putih	white
makanan	food
mata	eye
kek	Laughing
makin	more and more
kucing	cat
tanya	ask
bareng	with
ingin	want
yaudah	okay then
kena	Hit, got you
tes	test
pertama	first
jika	in case, just in case
ampun	Forgiveness
ketawa	Laugh
minta	ask for
melihat	Seeing, looking
mas	Title for man in their 20's to 40's
gws	Get Well Soon
selamat	safe
kubu	Stronghold, team
tiba-tiba	suddenly
laut	Sea
apalagi	especially
dapet	Dapet
bang	Bang
plastik	plastic
tau	know
yaitu	that is
belajar	study
maju	proceed
daun	Leaf
malah	rather
sebelum	before
pencet	push, press
ngambil	Take
agak	rather
sesuatu	something
parah	critical
kuning	yellow
tahun	year
bapak	father
dikit	little
weh	Informal way of calling someone
lari	run
tutup	closed
biru	blue
nomor	number
batu	stone
hati	"liver, ""hati-hati"" means careful"
ibu	Mother
beda	different
bintang	star
hiu	shark
lagu	song
nenek	grandmother
donasi	donation
ikut	follow
ada-ada	Silly
suaranya	his voice, her voice
hampir	almost
minggu	week
mohon	please
mari	let us
masalah	problem
really	Really
pulang	go home
nyanyi	singing
sayang	Dear
hal	Thing
ininya	This is (Suffix nya)
bukannya	instead
ku	my
kowe	You
percaya	believe
seru	exciting
nangis	cry
bener-bener	really
sebagai	as
lainnya	other
awas	watch out
gara-gara	Because of
diri	self
kenal	know
para	TYPX
where	WHERE
inget	remember
brush	Brush.
pintu	door
rezeki	Blessing
kambing	goat
foto	photo
es	ice
okay	Okay.
terakhir	final
mobil	car
kelihatan	Looks like
biji	seed
ela	Idiolect, person name
maunya	wants
serem	Scary
muncul	appear
mandi	bath
ulang	repeat
cek	check
asyik	fun
ting	Ting
setiap	every
sore	afternoon
burung	bird
menit	minute
kaya	rich
menang	win
kadang	sometimes
jago	champion
cantik	beautiful
teteh	Older woman title (Sundanese)
kerja	work
kalo	if
kapal	boat
kaget	startled
nyari	Looking for
sepatu	shoe
okelah	Okay
jelas	clear
capek	tired
jangan-jangan	perhaps
sedih	sad
empat	four
tentang	about
bobok	sleep
gigi	tooth
bagaimana	how
nene	TYPO
atuh	Idiolect, Ouch
mudah	easy
diambil	Taken
toh	Idiolect
mantap	steady
wes	Done (Javanese)
dek	Calling someone younger, deck
nunggu	waiting
telah	has
jadinya	so
marah	angry
seneng	Happy
barang	goods
mancing	fishing
sedang	currently
awal	beginning
mulu	always
males	lazy
tua	old
duit	money
ama	With
anjing	dog
fokus	focus
inilah	This is
jelek	bad
mending	Better
kirim	send
diam	Silence
mainnya	play
orangnya	People
dekat	close, near
abis	finish
kaki	foot
benar-benar	truly
itunya	That thing
entar	later
dikasih	given
bos	boss
beberapa	a number of
hari-hari	days
kira	think
cetak	Print
pa-pa	Pa
kayu	wood
kasihan	pity
fishing	Fishing
yg	which
pohon	tree
ngelihat	Seeing, looking
gampang	easy
nasi	rice
er	Er
demi	For the sake of
setengah	half
elah	Idiolect, Oh
tangan	hand
kunci	key
penguin	penguin
ga	Ga
teman	friend
isi	Fill
ceritanya	the story
itulah	that's
map	folder
ingat	remember
lima	five
klik	click
hati-hati	careful
berhenti	stop
sebelah	adjacent
deket	Near
hebat	great
sesuai	in accordance
review	review.
susu	milk
back	Back
gitulah	Through it
kupu-kupu	butterfly
pilih	select
engkau	you
seorang	a person
teori	theory
noah	Noah
dipakai	Worn
duluan	first
games	Games
sekolah	school
cowok	guy
disuruh	Being told
padahal	even though
sekalian	all, including
kuda	horse
cewek	girl
tanpa	without
nia	TYPO
teng	Teng
artinya	it means
pikir	think
meledak	explode, irrupt
boboiboy	A cartoon character form a cartoon serial Boboiboy
kakak	older brother
keh	TYPO, Ok
ella	Ella.
kirain	Thought
dunia	world
terjadi	occur
kagak	not
mu	your
nyampe	Arrived
dengar	hear
suruh	Saying
amin	Amen.
oli	oil
kubur	tomb
hm	Hmmm
pegang	hold
temen	Friends
gambar	picture
gas	gas
cie	Cie
ayam	chicken
slank	Slank
bersih	clean
silakan	please
gaya	style
bobo	Bobo
horor	Horror
bunga	flower
uang	money
sip	OK
muka	face
ngantuk	sleepy
kode	code
soal	question
gelap	dark
trust	Trust
mimpi	dream
ye	Yes
doa	prayer
baiklah	Okay
bahwa	that
siang	afternoon
ungu	purple
ta	tantalum, ta, atomic number 73
sono	Go away
baju	dress
asal	origin
arah	direction
goreng	fry
ketika	when
diem	Shut up
ngelag	Ngelag
dewi	goddess
bakso	meatball
kangen	miss
ngomongin	talking
baterai	battery
bersama	together
walaupun	although
sayur	vegetable
berusaha	attempt, try
tips	Tips
duh	Duh
segini	Some
turu	Turu.
siap-siap	get ready
mikir	thinking
orang-orang	people
dateng	Dateng
jawab	answer
ken	Ken.
tanda	sign
sedikit	a little
news	News
kuat	strong
kedua	second
gan	Bro
dayung	paddle
sehat	healthy
tim	team
friend	Friend
kini	now
pake	wear
cinta	love
berani	brave
bodoh	stupid
senyum	smile
dibuka	Opened
dibawa	brought
rasa	flavor
besar	big
rasanya	it feels like
anu	Anu.
panjang	long
gelas	glass
lantai	floor
kalah	lost
beban	burden
bagi	for, divide
senin	Monday
berenang	swimming
bau	smell
emangnya	TYPX
apanya	what
wek	Expression of disgust
terserah	up to you
aw	Aw.
mengerti	understand
eko	Eko.
noh	Noh
night	Night
desa	village
berdua	together
ride	Ride
ketik	type
senang	happy
pa	Look
cilor	Indonesian food created with tapioca starch and egg
oi	Oi
segala	all
dimakan	eaten
kebanyakan	most
maka	consequently, accordingly
akhir-akhir	Lately
tetapi	but
pusing	dizzy
lho	Idiolect, questioning something, confuse expression
barusan	just now
ngomongnya	Talking
ayu	Ayu.
hijau	green
eek	Eek.
menurut	according to
gamenya	Game
mi	Mi.
mirip	similar
ngapa	why
ngaku	Confess
hitam	black
amat	very
manusia	human
mean	Mean.
versi	version
kupu	Butterfly
mesin	machine
secara	in fact
kebo	Kebo.
supaya	So
terbang	fly
wih	Expression of amazement
justru	precisely
kembali	return
joe	Joe
wa	Wa
haduh	Ouch
hantu	ghost
loncat	jump
cocok	suitable
find	Find.
kabur	blurry
kulit	skin
airnya	The water
wortel	carrot
look	Look.
kepada	to
segitu	Such
daripada	than
bola	ball
jepang	Japan
kill	Kill
sama-sama	You're welcome
pula	also
tanah	land
dibilang	said
sini-sini	here here
lancar	fluent
setan	Devil
angin	wind
adanya	existence
membuat	make
wanita	woman
duduk	sit
mb	Mb.
selain	besides
main-main	While
lele	catfish
sekian	So much
muah	Muah
coba-coba	try try
indah	beautiful
dikejar	Chased
apapun	whatever
buku	book
waktunya	Time
teknik	technique
teman-teman	friends
toko	shop
ujung	end
lepas	free
down	Down
panik	panic
tombol	knob
sepertinya	it seems like
spike	Spike
translate	Translate
zeta	Zeta
kesana	Going there
ngomong-ngomong	by the way
angka	number
ai	Ai.
manis	sweet
baik-baik	fine
detik	second
buset	Buset
sibuk	busy
seven	seven
kamar	room
kimia	chemistry, chemical science
gini-gini	Gini-gini
minyak	oil
khai	Khai.
alat	tool
telat	late
warnanya	color
helm	Helm
dedes	Dedes
coklat	brown, brownish, chocolate-brown, dark-brown
timur	east
istri	wife
cakep	handsome
permisi	excuse me
zat	substance
adik	younger brother
jijik	dirty, soiled, unclean
mencari	look for
goblok	Stupid
samping	side
inggris	England
steam	Steam.
sempat	Had
babi	pig
selama	During
tiap	each
lumayan	reasonable
posisi	position
sahabat	friend
keren-keren	cool cool
surya	Sun
sulit	difficult
cepetan	hurry
berubah	changed
hingga	until
ajalah	Ajalah
nenek-nenek	grandmother
khair	Khair
sumpah	oath
penuh	full
menarik	interesting
izin	permission
yakin	convinced
non	non
ma	MA.
akunya	Me, myself
sebut	Call
mainin	Play it
bom	bomb
crush	Crush
cecak	lizard
denger	Listen
twitter	Twitter
tank	tank
akhir	end
abang	Abang
mencoba	try
bocah	Boy, little girl
api	fire
masak	cook
michael	Michael
wae	Wae
sebelumnya	previously
gagal	fail
musuh	enemy
tuhan	lord
bakar	burn
nyala	light up
suatu	something
sebenernya	actually
school	School
tetep	Tetep.
awalnya	Initially
going	Going.
jamur	mold
kosong	blank
adek	younger brother
koko	Koko
tangga	ladder
putar	Play
sempet	Sempet
meeting	Meeting
barangnya	The item
namun	however
ngobrol	Chat
ruang	room
bercanda	Kidding
dengerin	Listen
merasa	feel
keluarga	family
nulis	write
wedding	Wedding
file-nya	the file is
kepala	head
finally	Finally
ki	key
player	player
awan	cloud
yoi	yes, exactly
bulan	month
syaikh	Shaykh
kesel	annoyed
rumahnya	His house
indonesian	Indonesian
kepencet	Kepet
bekerja	work
tulis	writing, authorship, composition, penning
keke	Keke
ngapa-ngapain	Ngapa-do it
entah	who knows
sosial	social
demo	Demo
musik	music
tata	system
terlihat	seen
bareng-bareng	together
rusak	damaged
saudara	you
agar	so that
forever	Forever
tulisannya	Writing
kaca	glass
kai	OK
nyata	real
hewan	animal
putri	daughter
maksud	meaning
kawan	Friends
bermain	played
dada	chest
kerjaan	work
salam	regards
ane	Ane.
janji	promise
juta	million
ton	Ton.
metode	method
kelas	class
pindah	move
tentu	of course
istirahat	rest
sok	Sok
tungguin	Wait
black	Black
nek	Nek
hana	abandoned, derelict, deserted
ono	Ono
bagian	part
bagus-bagus	good, good
kira-kira	approximately
bahagia	happy
satunya	Only
tertutup	closed
dadah	cannabis, marijuana, marihuana, ganja
mana-mana	Everywhere
singa	lion
bisanya	usually
pink	Pink
reza	Reza
absen	roll call
nilai	mark, score
jujur	honest
asik	Asik
aceh	Aceh
pop	Pop
monyet	monkey
jalannya	Walk
khusus	expressly
klip	clip
iwan	Iwan
lama-lama	For a long time
menunggu	waiting
layar	screen
ilang	lost
ee	Ee.
kabel	cable
acara	program, event
pintunya	Does the door
tergantung	depends
watching	Watching.
buah	fruit
khan	Khan.
sepi	quiet
syuting	shoot
kasur	mattress
sengaja	on purpose
mesti	must
kefir	Kefir
foto-foto	taking pictures
guru	staff, faculty
berat	heavy
ditaruh	placed
bahkan	even
koboi	cowboy
chatnya	chat
dingin	cold
iso	Can do (Javanese)
iyo	Iyo
hancur	destroyed
kocak	Lociously
cuci	wash
inventory	Inventory
saku	pocket
lompat	jump, jumping
lampu	light
laper	Laper
bapaknya	His father
seseorang	somebody
bantu	help
ngajak	invite it
kota	city
jalan-jalan	go for a walk
takutnya	Fear
sopan	correctly, right, aright
pintar	clever
wajah	face
ngeri	Horrified
supercat	Supercat
share	Share
chan	Chan
sport	sport
smp	junior high school
bedanya	The difference
kedengeran	Remarintan
selanjutnya	next
tambah	plus
kotak	box
file-file	file-file
rambut	hair
aneh-aneh	Weird, weird
ide	idea
libur	vacation, holiday
mode	mode
obat	drug
aduk	blend, flux, mix, conflate, commingle, immix, fuse, coalesce, meld, combine, merge
iyalah	of course
nyoba	Nyoba
nembak	Shoot
jodoh	partner
buang	throw away
tante	aunt
nge-review	Review
bunuh	Kill
lebay	Overreacting
seblak	Seblak
asa	hope
halus	fine
tukang	craftsman
pesan	message
khas	typical
read	Read
namaku	My name is
les	lace
a-a-a-a	A-A-A-A
heh	Hey
nge-rap	Rap.
apalah	Apalah
pejuang	Fighters
pagi-pagi	early in the morning
ikannya	Fish
asli	original
tipe	type
mulut	mouth
net	net
diatas	on
lagunya	The song
semangka	watermelon
cepet-cepet	Cepet
simi	Simi.
biarin	Biarin
udahan	Done
momen	moment
saki	sake, saki, rice beer
kuncinya	Key
telepon	phone
um	um
bebas	free
mukanya	His face
naikin	Ride
nyuruh	Try it
tugas	Duty
respon	response
naik-naik	rise up
bantuin	Helpful
sosok	figure
rela	willing
days	Days.
perut	stomach
keras	hard
wis	Wis.
opo	OPO
cahaya	light
setia	loyal
nyam	Nyam
lem	glue
sang	the
ngecek	check out
lagi-lagi	again and again
hu	Hu.
seri	series
detail	Details
atasnya	over it
titik	point
matahari	sun
bertiga	Threesome
yusuf	Yusuf
mendingan	passable
hutan	Forest
tengah-tengah	middle
hayo	Hayo
ketiga	third
pacar	boyfriend, girlfriend
ngechat	Chatting
misi	mission
bosen	bored
otak	brain
escape	Escape
sensor	Sensor
ngikutin	Ngetnut
suci	chastely, virtuously
sekitar	around
naon	Naon
sabar-sabar	be patient
emosi	emotion
bales	reply
enno	Enno.
untung	profit
sebuah	a
kebetulan	as it happens
tetangga	neighbor
kebuka	Bro
kabar	news
perang	blond, blonde, light-haired
musuhnya	His enemies
pertanyaan	question
dibaca	be read
heran	care, attention, aid, tending
kue	cake
tubuh	body
tekan	press
max	Max
termasuk	including
cake	Cake
sinyal	signal
nasinya	rice
muter	Spin
menonton	watch
masalahnya	The problem is
hoi	Hoi.
kemana-mana	Everywhere
keju	cheese
sungguh	barely, hardly, just, scarcely, scarce
lari-lari	run
gw	Gw
lapar	hungry
cepat-cepat	Hurry up
crazy	Crazy.
indo	Indo
lakukan	do
sule	Sule
tembok	wall
matanya	His eyes
tamat	end, terminate
temennya	Friends
macam	type
pasir	sand
ganteng	handsome
suami	husband
yoga	Yoga.
telur	egg
kyt	Kyt.
rame	Rame.
utuh	intact
puzzle	Puzzle
lengket	sticky
disana	there
mei	May
kejar	chase, chase after, trail, tail, tag, give chase, dog, go after, track
smelter	Smelter
ditutup	Closed
truk	truck
canda	Canda
peduli	care
ilmu	knowledge
topik	topic
efek	effect
kegedean	too big
ngerjain	working
isu	publish, bring out, put out, issue, release
isinya	its contents
pelan-pelan	slowly
semut	ant
baru-baru	mahoe, majagua, mahagua, balibago, purau, hibiscus tiliaceus
melakukan	To do
kopi	coffee
naga	dragon, flying dragon, flying lizard
yey	Yey
buta	blind, unsighted
art	Art
estetik	aesthetic, esthetic, aesthetical, esthetical
mom	Mom
angkat	lift
gitar	guitar
grup	group
otw	OTW.
enam	six
okeh	Okay
betul-betul	true, true
pare	sour gourd
ruangan	room
hadiah	present
ko	Ko
badan	body
ngetes	Ngetes
ngakak	laugh out loud
anaknya	His child
huruf	letter
mekanik	Mechanical
jeruk	orange
cup	Cup
kasar	Rough
dilihat	Judging
tepat	appropriate
error	error
normal	straight
meja	table
mendengar	hear
care	Care.
berhasil	contract, take, get
meong	Meong
dokter	doctor
kursi	chair
bocil	Locil
tebak	guess
tersebut	the
ditunggu	awaited
version	Version.
ahmad	Ahmad
sd	SD
misalkan	Suppose
sehingga	so that
kemudian	then
heboh	up in arms
mahal	expensive
jiwa	soul
anak-anak	doll, dolly
epic	Epic.
lurus	straight
kurai	grain
bawang	onion
fitur	feature
caca	Caca
tanggal	date
rap	Rap.
nur	Nur.
muda	young
base	Base
pukul	time
nemu	found
pesawat	aircraft
bunda	mother
karya	creation
nu	nu
bunyi	sound
led	LED
antara	Among
membaca	read
enaknya	Delicious
janganlah	Don't
bacanya	read it
iki	iki.
komen	Comment
baca-baca	read
nama-nama	What is the name
berisik	noisy
matiin	Matiin
suku	ethnic group
berdiri	stand up
dc	DC
roro	Roro.
ikutin	Follow it
sma	senior high school
mengaku	confess
jawa	Java
lihat-lihat	looking around
goyang	shake
pisang	banana
cash	Cash
mimi	Mimi.
nelpon	Call
tadinya	once, formerly, at one time, erstwhile, erst
alis	eyebrow, brow, supercilium
seluruh	Own
kya	Kya.
panas	warm
sobat	Suddenly
nine	Nine
payung	umbrella
kejadian	incident, event
palu	hammer
neh	Neh
kenapa-napa	WHY-NAPA.
heel	Heel
ski	Ski
umur	age
akun	account
malu	blush, crimson, flush, redden
hasil	results
nyawa	life
banyak-banyak	much
resep	recipe, formula
jokowi	Jokowi
darah	blood
wuih	Wuih.
pecah	broken
pen	pen
soto	Soto.
jendela	window
bangga	gallant, lofty, majestic, proud
hamil	pregnant
suhu	temperature
listrik	electricity
server	Server
ribet	complicated
pikiran	thought
shadow	Shadow
wc	WC
sari	sari, saree
ketahuan	found out
al	Al.
gitu-gitu	That's so
rules	Rules
saatnya	It's time
pupuk	poultice, cataplasm, plaster
ngopi	drinking coffee
makhluk	creature
bolehlah	may I
begitulah	That's how it is
rajin	diligent
bikinin	Make it
room	Room
sadar	aware
nyangkut	stuck
pendek	short
napa	Napa.
tanaman	plant
mengapa	why
semakin	the more
nungguin	Wait
jarang	seldom
pro	pro
jalur	track
baron	baron
bocor	leaking
memakai	use
roti	bread
tas	bag
jejak	chase, chase after, trail, tail, tag, give chase, dog, go after, track
bikinnya	make it
penasaran	curious
boleh-boleh	Okay, okay
label	label
contoh	example
vs	vs.
angel	Angel.
botol	bottle
piring	dish
laku	in demand
gizi	Nutrition
nyi	Nyi.
pistol	gun
seni	art
generator	generator
kodok	frog
bahas	discuss
pantai	beach
mengambil	take
kamunya	Kamunya
check	Check
besoknya	next day
resmi	formal
maupun	And
walau	although
ujian	examination, testing
tu	Tu.
brand	Brand.
wei	Wei.
paket	package
nambah	add it
rumahku	My house
menghilang	disappear
menangis	cry
pegangan	apprehension, arrest, catch, collar, pinch, taking into custody
polisi	police
rencana	plan
nada	tone
baduy	Baduy.
tahan	stand
nyaman	comfortably
berguna	beneficial, good
tokyo	Tokyo
leader	Leader
mendapatkan	got
moderator	moderator
sampah	rubbish
karakter	character
pemalu	bashful
hammer	Hammer
muhammad	Muhammad
tangannya	His hand
kisah	story
woah	Woah.
iman	faith
stage	Stage.
tarik	pull, pulling
nengok	look
tanda-tanda	signs
bertanya	ask
angeles	Angeles
dewa	god
kidul	south
final	finale, close, closing curtain, finis
kereta	Train
plants	Plants.
ehem	hem, ahem
dua-duanya	both
imut	tiny
gerak	Motion
datsun	Datsun
masing-masing	each
tenet	Tenet
wajib	must
kehidupan	life
fix	Fix
seharusnya	adultery, criminal conversation, fornication
sialan	Damn
hafal	memorize
ac	air conditioning
pasang	rise, go up, climb
bae	Bae
latihan	practice
ngepet	A dark ritual where you summon a pig to steal other's money or treasure 
kontrol	control
tembak	shooting, shot
berantem	fight
sukanya	Look
ning	Ning.
emas	gold, golden, gilded
apel	apple
anggap	assume, presume, take for granted
raya	Raya
usaha	feat, effort, exploit
negara	state
potong	edit, blue-pencil, delete
malem	night
jauh-jauh	Fareness
rizky	Rizky
intinya	the main thing is
fotonya	His photo
kado	gift
jeju	Jeju.
deskripsi	description
saling	each other
gambarnya	picture
ahli	expert
duyung	Mermaid
panggil	Call
nikah	marry
ganggu	disturb
mantra	Mantra
dimengerti	Understandably
sejak	since
langit	sky
calon	candidate
drink	Drink
zero	Zero
masjid	Mosque
oke-oke	Okay, okay
amazing	Amazing
nginep	stay overnight
end	end
botak	bald
bayar	pay
berpikir	think, believe, consider, conceive
beda-beda	Different
wangi	beautiful
permen	candy, confect
jaga	keep
masukin	insert
ding	Ding.
jangkar	anchor
menu	menu, bill of fare, card, carte du jour, carte
city	City
sel	cell
kamera	camera, photographic camera
yi	Yi
lawan	against the clock, against time
segera	quick
tingkat	level
cabut	blackjack, twenty-one, vingt-et-un
nyamuk	mosquito
ngaji	Said
senjata	weapon
nomornya	Number
blacksmith	Blacksmith
seta	Seta.
pasrah	resigned
daging	fiber, fibre, vulcanized fiber
pancingan	inducement, fishing rod
dibikin	contrived
energi	energy
siapa-siapa	Who
inggrisnya	English
pos	post
aksi	action
membantu	help
melangkah	Stepping
ngono	Ngono
feeling	Feeling
iyah	yes
diajak	Despite
macet	congested
disebut	Called
aya	Aya
link	link
turut	In contrast
belakangnya	behind it
ndah	Ndah
ditanya	Asked
inikah	Inikah.
maret	March
lahir	born
spam	Spam
iyakah	Is not it
perasaan	feeling
tray	Tray
kongres	congress
kobokan	finger bowl
ae	Ae.
lelah	tired
depannya	front
pong	Pong
dede	Dede
nona	Miss
hubungan	connection
gantian	take turns
trus	While
sim	SIM
usai	break up, crack up
willy	Willy.
ori	ORI.
saking	Such
merek	brand
melawan	oppose
nabi	prophet
terang	light
murah	inexpensive
sisi	side
kuliah	lecture, lecturing
manggil	Call
kang	Kang.
sempurna	perfect
survei	survey
sehari	a day
jenis	type
menyerah	surrender
tidurnya	sleep
nafas	breathe, take a breath, respire, suspire
daya	power
dibuat	Made
tatakae	Tatakae
rendah	low
nda	Nda
gendut	pregnant
ajak	invite
terbaik	best
utara	north, northerly, northwards, northward
proses	process, physical process
sementara	temporary
monster	bogeyman, bugbear, bugaboo, boogeyman, booger
wahyu	revelation
kwe	Kwe.
kecap	soy sauce, soy
keempat	fourthly, fourth
bengkel	workshop
pisau	dagger, sticker
lemah	hardscrabble
bun	Bun.
keluarin	Exciting
nak	Son
nana	Nana.
asing	foreign
prank	Prank.
utama	main
kunjung	visit
dance	Dance
videonya	Video
mc	MC.
ditembak	Shot
la	la
hapus	delete
elo	Elo.
balikin	Balikin
hpnya	His mobile phone
tangki	tank, storage tank
matte	Matte.
dikira	Thinkled
jadwal	timetable
enggan	reluctant
pingin	Pingin
hilangkan	Remove it
warga	inhabitant
drive	Drive
match	Match.
liat	Look
boneka	doll
skripsi	essay
setuju	agree
pengalaman	experience
kapalnya	Ship
desain	design
jumlah	measure, quantity, amount
screenshot	Screenshot
sisa	remainder
kelapa	coconut
menuju	going to
cerita-cerita	Story-story
pain	pint
bogor	sugar palm, gomuti, gomuti palm, arenga pinnata
belok	swerve, swerving, veering
suka-suka	up to
beb	Bet
pocong	pocong
jahat	baleful, forbidding, menacing, minacious, minatory, ominous, sinister, threatening
jogja	Jogja
tolol	stupid
harga	price
wujud	actual, existent
ngeliat	see
permainan	game
tikus	mouse
berita	news
dicoba	tried
berikutnya	next
bertahan	endure
jok	car seat
pinjem	borrow
luka	wound
krimnya	the cream
hem	Hem
dasar	base
layak	worthy
beliau	he
rom	Rom
miring	crooked
lengkap	complete
milik	owned by
membawa	bring
deket-deket	Deket-near
doh	Doh
raja	king
km	kilometer, kilometre, km, klick
kacau	confused
mobile	Mobile
bacot	trap, cakehole, hole, maw, yap, gob
sabtu	Saturday
put	Put
bumi	earth
tempatnya	Place
komentar	comment
keadaan	Lecturing
kreatif	clever, cunning, ingenious
suara-suara	Voice
kerjanya	works
dicat	painted
muat	Load
boat	Boat
fish	Fish
jus	juice, succus
meninggal	die
aha	Aha
pindahin	Move
sampai-sampai	even
hasilnya	As a result
nitip	Nitip
anggota	member
anti	anti
tiba	arrive
waris	inheritance, heritage
ngeng	Mr.
krim	cream, ointment, emollient
arti	multivalent, multi-valued
karma	Karma
subuh	dawn
maling	burglar
puasa	fast
gelut	wrestle, wrestling, grapple, grappling, hand-to-hand struggle
wakwakwakwakwak	Wakwakwakwak.
bayangin	Shadow
kebaca	Kebaca
taunya	Taunya
mangga	mango
berlari	run
batin	inward
kebiasaan	habit
teguh	Teguh.
suaraku	My voice
jin	spirit, disembodied spirit
fresh	Fresh.
kubus	cube
gunung	Mountain
niat	motivation, motive, need
teknologi	technology
cita-cita	ambition
berwarna	color, colour
ular	snake
maut	death
yeyeye	Yeyeye
mampu	capable
pelajaran	lesson
hiunya	Holiness
lilin	candle, taper, wax light
skrub	Scrub
milih	Choose
bubur	porridge
umum	general
icha	Icha
sebanyak	as much
modern	modern
donation	Donation
jaksel	South Jakarta
sombong	proud
korek	match
dedek	Dedek
tersenyum	smile
ketua	chairman
nyonya	Mrs
otot	muscle
ragu	doubt
tokek	gecko
memilih	modify, qualify
hulk	Hulk
putus	separated
konon	It is said
toilet	toilet, lavatory, lav, can, john, privy, bathroom
akeh	Akh
batas	limit, circumscribe, confine
yee	Yee
taro	Taro.
pusat	center
emot	Emoji
sukses	successful
kenceng	fast
mencet	Mend.
bentuk	shape
lulus	Graduated
sabun	soap
jeta	Jeta
yan	Yan
raffi	Raffi
buru-buru	in a hurry
segi	Strongness
ceritain	Ceritain
bahan	ingredients
tali	rope
artis	artist
media	medium
berasa	taste
dibawah	under
mak	a.m.
judul	title
tiket	Ticket
tol	toll
bentuknya	Its form
jual	sell
hal-hal	things
pala	nutmeg
kecuali	except
negeri	country
dongeng	fairytale
tujuh	seven
jahe	ginger, gingerroot
btw	BTW.
mantep	Mantep
kentang	potato
dikit-dikit	a little
per	per
menyenangkan	pleasant
tanggung	not quite enough
ngefans	Ngefans
ahok	Ahok.
seekor	A.
cicak	house lizard
gunanya	Use
iri	covetous, envious, jealous
mega	cloud
tidaknya	No.
otomatis	automatic
sungai	river
berjalan	walk
gedein	Gedein.
kandang	barn
mayo	Mayo
los	Los.
coy	Coy
bebek	duck
gabut	Gabut.
akui	Acknowledge
sihir	magic
saga	Saga.
ogoh-ogoh	Ogoh-Ogoh.
zaman	time
daerah	area
bekas	used
baguslah	Good
ngebut	speeding up
gajah	elephant
rina	Rina
cobain	try it
silver	Silver
tatang	port
tulisan	writing, committal to writing
david	David
semen	cement
gerbang	gate
malaysia	Malaysia
kepalanya	His head
meskipun	although
lemon	lemony, lemonlike, sourish, tangy, tart
cina	China
mikirin	think
craft	Craft
antarnusa	Instusters
adakah	Adakah
haloo	Haloo
topi	hat
nyaris	Almost
ayolah	come on
tong	Tong
bolong	black
reload	Reload
makannya	Eat
ramai	crowded
beliin	Buyin
kolam	pool
favorit	favorite, favourite
kijang	deer
delapan	eight
gendong	cradle
kenapa-kenapa	Why? Why
musiknya	the music
pilihan	choice
mencapai	reach
kering	dry
dorong	push
hak	possession, ownership
misal	example
aman-aman	safe-safe
ilham	inspiration
ngambek	sulk
lirik	lyrical
kartu	card
betapa	how
ngejar	Claring
yeh	Yeh.
gede-gede	Gede-big
pahit	acrimonious, bitter
hidung	rhinal, nasal
spray	Spray.
dewasa	mature
nikel	nickel
yogs	Yogs.
piece	A piece
memiliki	own
seandainya	if
damai	peace
simpan	save
aligato	Aligato.
plastiknya	plastic
ramah	friendly
pura-pura	affected
hari-harimu	Your days
jernih	clear
kotor	dirty
laptop	laptop, laptop computer
yu	shark
chance	Chance
sah	legally
keluarkan	Remove
awet	durable
kadang-kadang	occasionally, on occasion, once in a while, now and then, now and again, at times, from time to time
deketin	Deketin
frank	Frank.
bukti	validation, proof, substantiation
strategi	strategic, strategical
alam	nature
bila	when
salat	salat, salaat, salah, salaah
letak	put, set, place, pose, position, lay
injak	Stir up
bayi	baby
penonton	viewer
dwi	bi
mesinnya	machine
tertarik	interested
makan-makan	eating out
biarkan	let
malam-malam	late at night
beta	Beta
kesehatan	health
siapapun	anybody
uti	UTI
jumat	Friday
tomat	manhattan clam chowder
andai	example, illustration, instance, representative
paku	nail
barengan	Barengan.
dimasak	cooked
ngerasa	Felt
berbagai	divers(a), diverse
celine	Celine
auto	Auto.
alasan	reason
blade	Blade
aslinya	originally
kredit	credit
lupakan	forget it
nol	zero, zero point
keinget	Keinget
sendok	spoon
positif	positive
bapak-bapak	gentlemen
pin	pin
dipanggil	Called
pedas	spicy
tumbal	amulet, talisman
yei	Yei.
mataku	My eyes
mayat	Corpse
ehe	Ehe
presiden	president
ayo-ayo	Come on, come on
nyesel	Nyesel
wisata	tourism, touristry
hampa	empty
jadikan	induce, stimulate, cause, have, get, make
potato	Potato.
mati-mati	Death-dead
jemput	pick-up
bentar-bentar	Wait a minute
cacing	worm
patung	dragonfly, darning needle, devil's darning needle, sewing needle, snake feeder, snake doctor, mosquito hawk, skeeter hawk
surat	letter
maneh	again
bab	round, around
sentuh	touch, touching
bubar	break up, disperse, scatter
keburu	Kebur.
kompas	compass
healthy	Healthy
terjun	plunge
pr	Pr.
teriak	shout
ngegas	Despite
sopo	Sopo
nafsu	lust
donat	donuts
stres	Stress
tamu	visitor
selnya	His cell
riset	research
sikat	comb, comb out, disentangle
karet	rubber, natural rubber, india rubber, gum elastic, caoutchouc
selesaikan	finish
rasain	Rasain
aqua	Aqua.
aktif	active
rem	brake
luas	large
kakinya	His legs
binatang	animal
nyantai	relax
drag	Drag
comeback	Comeback
ras	race
nyalain	turn on
jas	suit
mengeluarkan	puff, huff, chuff
secure	Secure
peta	map
saran	suggestion
jono	Jono
bertemu	meet
menatap	Staring
diapain	What are you doing
tunai	instantaneously, outright, instantly, in a flash
tepuk	applaud, pat, clap
piye	Piye
bus	bus, autobus, coach, charabanc, double-decker, jitney, motorbus, motorcoach, omnibus, passenger vehicle
mulutnya	His mouth
mengerikan	atrocious, frightful, horrifying, horrible, ugly
burhan	Burhan
cabang	branch
pleng	Pleng
rambutnya	Hair
matinya	Death
gedung	building
edisi	edition
gogogogogo	Gogogogogo
kela	Kelala.
ngebet	Ngebet
tinggi-tinggi	High-height
tato	Tattoo
penghujan	Hash
kanada	Canada
yogurt	yogurt, yoghurt, yoghourt
ngirim	Send
bruce	Bruce
matematika	mathematics
haji	hajj, haj, hadj
keong	escargot, snail
repot	hassle
diganti	replaced
salah-salah	You might be
pulangnya	Rome
daunnya	Leaves
komedi	amusing, comic, comical, funny, laughable, mirthful, risible
ekor	trace, follow
licin	crafty, cunning, dodgy, foxy, guileful, knavish, slick, sly, tricksy, tricky, wily
tengok	Look
gurun	godforsaken, waste, wild
reaksi	reaction
rata	alkaline, alkalic
paha	thigh
barang-barang	baggage, luggage
celana	trousers
kejauhan	distance
siapin	Preparedness
ayat	paragraph
ampe	Ampe.
rileks	relax
knalpot	exhaust
lebar	wide
nagih	Nagih
jarak	distance
kilo	kilometer, kilometre, km, klick
ost	Ost
engko	partner
kacamata	spectacles, specs, eyeglasses, glasses
closing	Closing
cium	kiss, buss, osculation
natal	Christmas
sign	Sign
party	Party.
gratis	complimentary, costless, free, gratis(p), gratuitous
12.00	12.00.
bilangnya	say it
kecewa	flaw, blemish
lokasi	location
rumput	herbaceous
kedengaran	Sound
wadah	receptacle
ojo	Ojo.
seks	sexual activity, sexual practice, sex, sex activity
dapur	kitchen
turun-turun	Down
square	Square
telor	accent, speech pattern
dibuang	discarded
perempuan	woman
sepeda	bicycle
yakni	namely
terkenal	notoriously
barbar	barbary
abdul	Abdul.
ngetiknya	typing it
badai	storm
bugil	Nude
trisula	trident
standing	Standing.
menggunakan	use
duelist	Duelist
gula	pecan pie
tiang	pole
stok	stock
jongkok	squat
kematian	Dead
nyalahin	blade
des	DES.
memancing	fishing
beres	clear, solve
naiknya	rise
memicu	Trigger
pelet	Pellet
adi	Adi.
berkali-kali	frequently, often, oftentimes, oft, ofttimes
fakta	factual
trek	Track
buzz	Buzz.
point	point.
udara	air
lempar	throw
murid	student
melihatnya	see it
satu-satu	one by one
tayang	Express
tupai	squirrel
berada	is at
kala	time
menamatkan	finish, finishing
jasa	service
bersinar	agleam, gleaming, nitid
sorry-sorry	Sorry-sorry
musim	season
genre	type
padang	Padang
kondisi	condition
maafkan	sorry
nyentuh	Touch
wong	Wong
karo	Karo.
fungsi	function
jati	fine
dirimu	yourself
proyek	stick out, protrude, jut out, jut, project
mengatakan	speculate, theorize, theorise, conjecture, hypothesize, hypothesise, hypothecate, suppose
kekuatan	strength
bahaya	risk, peril, danger
baka	Baka.
mawar	rose
motif	motivation, motive, need
pai	pie
uc	UC
roh	spirit
lubang	bore, bore-hole, drill hole
pemain	player
simbol	emblematic, emblematical, symbolic, symbolical
segmen	segment, section
soffel	Soffel
pacarnya	His girlfriend
imin	Imin
koleksi	collection
tombak	spear
duri	barb
mampir	Stop by
jatah	Ration
tonton	Watch
basket	Basketball
figur	figure
dog	Dog.
kenyang	fare
agen	instrument, tool
nyetir	drive
misteri	mystery
kompleks	complex
tembakau	tobacco
kantor	office, business office
maya	magic trick, conjuring trick, trick, magic, legerdemain, conjuration, thaumaturgy, illusion, deception
campur	blend, flux, mix, conflate, commingle, immix, fuse, coalesce, meld, combine, merge
dicek	checked
mainan	toy
setempat	local
arus	course, course of action
atur	arrange, set up, put, order
handal	feat, effort, exploit
singkil	Singkil.
design	Design
omedeto	Omedeto
rock	rock 'n' roll, rock'n'roll, rock-and-roll, rock and roll, rock, rock music
wibowo	Wibowo
gombal	crap
olahraga	sport
kekasih	lover
agus	Agus.
memberi	give
password	Password
dahulu	for the moment, for the time being
peti	chest
doa-doa	Prayers
besi	iron, smoothing iron
paham	understand
kumpul	gather
temenin	Temenin
istrinya	His wife
atlet	athlete, jock
kebun	garden
kubuka	I opened
surga	heaven
terkadang	sometimes
gatal	itch
salju	snow
semesta	whole
komputer	computer
bernama	named
membeli	buy
pulsa	pulse
ujan	rain
bagusnya	Good
semacam	alike(p), similar, like
beginian	Besinian
merupakan	represent
kipas	fan
sage	sage
seger	fresh
seksi	sexy
gaib	Gaib.
kontainer	Container
dokumen	document
burungnya	Bird
dompet	bag, handbag, pocketbook, purse
mikirnya	Think it
ajeng	Ajeng.
lagian	After all)
pulaunya	Alone
yay	Yay
esok	tomorrow
nontonin	watch
panggung	stage
tengkyu	Tengkyu
odong-odong	Odong-odong
bahasanya	the language
tebing	brim, rim, lip
kuota	quota
area	Area
order	ordering, order, ordination
mal	Mall
kuburkan	Brush
kemarau	drought
juli	july
matikan	turn off
sebetulnya	actually
bi	BI.
dikirim	sent
bitch	Bitch
mening	Mening.
logo	Logo
un	UN
hangat	full of life, lively, vital
doain	Prayer
muslim	muslim, moslem, islamic
mencuri	steal, slip
jembatan	bridge, span
mengikuti	follow
dipilih	chosen
bergerak	be active, move
bet	Bet
kacang	cinch, breeze, picnic, snap, duck soup, child's play, pushover, walkover, piece of cake
tersesat	lost
dik	Dik
barangku	Force it
nyuruh-nyuruh	Try to tell
rena	Rena
datangkan	Dress out
suaminya	Her husband
kesurupan	trance
silahkan	please
halnya	Hey
lanjutkan	continue
berkata	Come on
nyobain	Mobain
sejarah	historical
chord	Chord
biaya	cost
minuman	drink
hukum	law
ngumpet	Hiding
munculnya	appearance
berbeda	divers(a), diverse
berdoa	pray
mamanya	Her mother
masukkin	Linkin
medan	stadium, bowl, arena, sports stadium
fit	fit
serta	as well as
jaring	net
urusan	affairs
rok	skirt
jo	Jo.
manager	Manager
trend	vogue, trend, style
kiss	Kiss
mengenai	about
ratu	Queen
saus	banana split
memakan	demolish, destroy
semester	semester
pay	Pay.
agak-agak	rather
hobi	pastime, interest, pursuit
gita	Gita
usia	age
jagain	Jagain
beri	Beri
dimarahin	scolded
minumnya	Drink it
gokil	Gokil
mp4	MP4
kemenangan	success
transfer	transportation, transport, transfer, transferral, conveyance
embek	baa
makna	mean
menghibur	cheer, cheer up, jolly along, jolly up
hoki	hockey
kalimat	sentence
dikenal	known
klo	Klo.
hoax	Hoax
gameplay	Gameplay
matang	ripe
basah	drench, douse, dowse, soak, sop, souse
nyadar	realize
bulu	hair
sendirian	alone
semi	semi-
idea	idea, thought
tahu-tahu	Know
jajan	snacking
betulin	well
penis	penis, phallus, member
cumi	squid
tercipta	put, set, place, pose, position, lay
sunshine	Sunshine
yaya	Yaya.
asin	salty
dikata	Dikata
katakan	say
gaji	remuneration
sims	Sims.
sisanya	the rest
ikan-ikan	fish
yoghurt	yogurt, yoghurt, yoghourt
benci	vomit, vomit up, purge, cast, sick, cat, be sick, disgorge, regorge, retch, puke, barf, spew, spue, chuck, upchuck, honk, regurgitate, throw up
ji	Ji
deret	course, row
ngetik-ngetik	typing
islam	Islam
ekornya	tail
pantat	buttocks, nates, arse, butt, backside, bum, buns, can, fundament, hindquarters, hind end, keister, posterior, prat, rear, rear end, rump, stern, seat, tail, tail end, tooshie, tush, bottom, behind, derriere, fanny, ass
sering-sering	sometimes
diklik	clicked
kaila	Kaila.
aisyah	Ayesha
bicara	hash out, discuss, talk over
bego	Dego
ekstrim	extreme
danau	lake
membuka	open
billing	Billing
diam-diam	softly, quietly
pojok	corner
neon	neon
pesannya	Message
alex	Alex.
angker	haunted
satu-satunya	alone(p), unique, unequaled, unequalled, unparalleled
pacet	Pacet
deta	Deta
pertanyaannya	the question
papan	board
voting	Voting
stories	Stories
tujuan	objective
ngumpulin	Collect
tibet	Tibet
mengalami	experience
segede	Segede
atap	roofing
tingkil	Tingkil
bopeng	pockmarked
ustad	Ustad
ditinggal	left
kelinci	rabbit, coney, cony
kalem	calm
nobar	Nobar
negatif	negative
sikap	attitude
singkat	short
sapi	cattle, cows, kine, oxen, bos taurus
galau	noise, interference, disturbance
catat	note
gih	Gih.
kampung	rural
cilok	Cilok.
mengingat	remember
nasional	national
buaya	crocodile
bjm	BJM
menikmati	enjoy
mint	Mint
miami	Miami.
kene	Kene
tebel	Tebel
mewah	lavishly, richly, extravagantly
kencang	blustering(a), blusterous, blustery
tema	subject, content, depicted object
betah	habituate, accustom
topeng	mask
baiknya	good
menemukan	find
kebakaran	fire, firing
laki-laki	male
total	complete
serial	serial
obatnya	Medicine
menguning	turn
profesional	profession
generasi	generation
sahur	Sahur
wib	Write
lokal	homegrown
temanku	my friend
udang	shrimp
positive	Positive
tumbuh	grow, develop, produce, get, acquire
em	em, pica em, pica
cak	Cak.
abu-abu	gray, grayness, grey, greyness
logika	logic
bersuara	Meaning
koh	Koh.
kobok	group
bayangan	shadow
gadis	girl
murni	pure
nanyain	Nanyain
hening	crystalline, crystal clear, limpid, lucid, pellucid, transparent
harap	hope, go for
nyangka	Amordless
dimensi	measure, quantity, amount
dibakar	bake
aturan	rule
pahlawan	hero
tri	Tri.
butuhkan	need
menjawab	answer
kain	cloth
menghindari	avoid
streamingnya	Streaming
go-jek	Go-jek.
left	Left.
jaya	successful
guna	use, utilize, utilise, apply, employ
buruk	bad
memori	Memory
lemes	Lemes
naikkan	Raise
ditambah	increase
muter-muter	round and round
joknya	his seat
kamis	thursday, th
pasien	patient
bulat	round, round out, round off
amanah	trust, swear, rely, bank
jari	finger
menjeda	Acrewing
giliran	knock, belt, rap, whack, whang
batik	batik
tenggelam	sink
tenang-tenang	calm down
cerai	divorced
deng	Deng.
nget	Nget
kulihat	I see
cerah	bright
hore	Hooray
syaiful	SYAIFUL
menyebut	mention it
asih	Ayih
lihatin	Look at it
pinggir	edge
oksigen	oxygen, o, atomic number 8
agung	great
kuku	nail
wahai	unfortunately, unluckily, regrettably, alas
cah	Such
sandi	Code
pemanasan	warm-up, tune-up, prolusion
siswa	student, pupil, educatee
alif	Alif
curiga	doubtful, dubious
pita	tape
demikian	indeed, so
kuasa	influence
ucap	Said
salon	salon
gato	Gato.
operasi	operation
diva	Diva.
mengejar	hunt, run, hunt down, track down
dosen	lecturer
ranjang	bed
aset	asset
bagi-bagi	Share
dicetak	printed
berikut	subsequent
garing	crisp
jualan	Jualan
misterius	Mysterious
ig	ig.
menerima	accept
tasnya	Bags
iseng	joking
produk	commodity, trade good, good
cair	liquid
mengatur	dress, arrange, set, do, coif, coiffe, coiffure
temannya	her friend
elemen	component, constituent, element
bisnis	business
sembunyi	hide
kenalan	friend, quaker
belakangan	Later
selimuti	Selimuti
ribut	busy
sapu	daub
kedinginan	cool off
lewatin	Through it
distrik	administrative district, administrative division, territorial division
nang	Nang
segar	impertinently, saucily, pertly, freshly, impudently
ngajar	taught
semalam	yesterday
kalinya	the river
tinju	boxing
jakarta	Jakarta
lee	Lee.
benda	thing
kebutuhan	necessity, essential, requirement, requisite, necessary
tersendiri	Alone
begituan	like that
fadli	Fadli
menyala	sunburn, burn
meong-meong	Meow, meow
ataupun	or
kmu	Kmu.
kostum	custom
akibat	come, follow
alay	over acting
ngagetin	Ngagetin
puas	satisfied
antar	between
minat	pastime, interest, pursuit
membunuh	kill
berteman	companionable
kapten	captain
lampunya	Lampnya
tepung	meal
komik	comic
keributan	commotion
wait	wait
mendayung	row
anakku	my child
tea	Tea
yaudahlah	Oh yes
ceweknya	His girl
adem	peaceful, peaceable
kuah	dressing, medical dressing
celah	gap, crack
warnet	cafe
betina	female
kep	cap
tewas	Killed
daun-daun	Leaves
mengetahui	know
gosong	bar
elsa	Elsa
nanti-nanti	Later later
kuping	scale, scurf, exfoliation
saat-saat	When-time
mencetak	shape, form
barat	west
ndut	Ndut.
uji	test
pasta	pasta, alimentary paste
ditekan	pressed
yuri	Yuri.
perkenalkan	introduce
rute	path, route, itinerary
ceo	CEO
nakal	brash, cheeky, nervy
ditabrak	hit
sunset	Sunset
ampuh	Powerfulness
akut	I
metu	Metu
bersahaja	lifelike, natural
bbm-nya	BBM
paya	bog, peat bog
introduction	Introduction
cuaca	weather
nova	nova
membangun	grow
sate	satay
anteng	calm
cv	CV.
terbuka	open
editor	editor, editor in chief
nenet	Nenet
sistem	system
nyetok	Dress out
memulai	get down, begin, get, start out, start, set about, set out, commence
renang	swimming, swim
kokobop	Kokobop
pelaku	actor, doer, worker
pedang	sword, blade, brand, steel
ajar	teach, learn, instruct
ngingetin	Ngetetin
candra	Candra
miskin	bony, cadaverous, emaciated, gaunt, haggard, pinched, skeletal, wasted
menunjukkan	exhale, give forth, emanate
melompat	jump
bak	bin
menjauh	avoid
andi	Andi.
bilangin	say
karpet	rug, carpet, carpeting
letkol	Lieutenant Colonel
jemur	Jemur
bernyanyi	chant, intone, intonate, cantillate
lembek	soft
boom	Boom.
nan	world health organization, who
annyeong	Annyeong
jurang	gap, spread
subrek	Subrek
curang	Alazing
tik	Tik
jantung	cardiac
temanimu	Your friend
lemari	cupboard
iyan	Iyan
nontonnya	watch it
ara	fig
gordon	Gordon
simulator	simulator
maem	Maem
mentah	raw
tokoh	figure
pria	Men
backup	Backup
edi	Edi.
ketut	Ketut
jose	Jose
rahasia	dark
gigit	bite
pawang	Pawang
novi	Novi.
teduh	shady, shadowed, shadowy, umbrageous
petani	countryman, ruralist
wak	Wak
pamit	Pamit
sesi	session
ditulis	written
diskon	discount
dingo	Dingo
bersyukur	grateful, thankful
abah	dad, dada, daddy, pa, papa, pappa, pop
janda	widow
publik	public
berangkat	departure, going, going away, leaving
se	one, 1, i, ace, single, unity
konsep	concept, conception, construct
dipegang	held
petak	diagram, plot
usir	Exile
jorok	untidy
habib	Habib
hohoho	Hohoho
goyah	unaffixed, loose
kenzou	Kenzou
ditarik	draw, pull, pull out, get out, take out
spesial	particular(a), peculiar(a), special(a)
kurus	reduce, melt off, lose weight, slim, slenderize, thin, slim down
11.00	11.00.
terpakai	use, utilize, utilise, apply, employ
tiada	not, non
seseorangnya	Someone
nusa	Nusa.
kebawah	down
cowoknya	His guy
ikhwan	friend, quaker
klub	cabaret, nightclub, night club, club, nightspot
kecelakaan	accident
yesus	Jesus
selamanya	always, ever, e'er
balai	gallery
mitos	fabulous, mythic, mythical, mythologic, mythological
blender	blender, liquidizer, liquidiser
warna-warni	motley, calico, multicolor, multi-color, multicolour, multi-colour, multicolored, multi-colored, multicoloured, multi-coloured, painted, particolored, particoloured, piebald, pied, varicolored, varicoloured
mamang	confused
segitiga	square
korea	Korea
protagonis	protagonist, agonist
pekerjaan	profession
roda	wheel
insight	Insight
kos	expense, disbursal, disbursement
koran	paper
grillnya	Grill
rabu	wednesday, midweek, wed
cing	jail, jailhouse, gaol, clink, slammer, poky, pokey
mabuk	high, in high spirits
kebelakang	to the back
langkah	step
sel-sel	Cells
kutu	Lice
kebal	immune
luna	Luna
death	Death.
lili	lily
itik	duck
bukanya	Not
rintangan	obstruction
moral	moral
bangun-bangun	country borage, coleus aromaticus, coleus amboinicus, plectranthus amboinicus
kaos	jersey, t-shirt, tee shirt
burung-burung	Birds
setingkil	Selekil
hidupku	my life
royal	Royal
putar-putar	go around
swt	SWT
kebahagiaan	happiness
ubah	change, alter, vary
berlalu	Own
sederhana	merely, simply, just, only, but
bersemangat	enthusiastic
keajaiban	phenomenon
catatan	run, tally
percuma	While it is useless
palsu	counterfeit, imitative
sebab	because
kasus	event
tari	dance
rindu	neglect, pretermit, omit, drop, miss, leave out, overlook, overleap
opsi	option, alternative, choice
log	logarithm, log
konflik	battle, conflict, fight, engagement
adegan	scene, shot
remaja	adolescent
inget-inget	Inget
kuburan	grave
reog	Reog.
restu	blessing, benediction
hemat	economical
kemungkinan	possibility
ogah	Ogah
ngapa-ngapa	Anyone
kesal	dejected
re	Re.
nyai	mistress
menyentuh	partake, touch
kelompok	group, grouping
mempunyai	give birth, deliver, bear, birth, have
menulis	expense, write off, write down
ribu	thousand-fold, thousand times
pertama-tama	basically, fundamentally, essentially
tegang	tense, strain, tense up
presentasi	presentation, introduction, intro
melayu	malay, malayan
ilmiah	knowing, knowledgeable, learned, lettered, well-educated, well-read
banteng	bull
vallen	Vallen
jumpa	See it
bapakku	my father
tanam	plant, set
lafalkan	praises
qobul	Qobul
mid	Mid.
gelasnya	The glass is
kaku	freeze
terhadap	to
parkir	parking
seakan	As if
kecilnya	Small
teriak-teriak	shouted
berkurang	relax, unstrain, unlax, loosen up, unwind, make relaxed
neo	neo
daftar	list
sanggup	canker
kawin	coupling, mating, pairing, conjugation, union, sexual union
sekedar	merely, simply, just, only, but
mendapat	get
tony	Tony.
takkan	Takkan
unik	unique
ditanyain	Asked
pasar	market
fany	Fany
planet	planetal, planetary
emak	ma, mama, mamma, mom, momma, mommy, mammy, mum, mummy
sheikh	sheik, tribal sheik, sheikh, tribal sheikh, arab chief
eropa	Europe
lapor	report
bolak-balik	back and forth, backward and forward, to and fro
terbaru	up-to-the-minute, latest
lapis	coating, coat
dagang	commercial enterprise, business enterprise, business
galak	actively
aah	ooh, aah
sarapan	breakfast
puji	praise
seram	Seram
bencana	disaster
yunus	Yunus
tahi	feculent
cengkeh	clove
kubilang	I said
ketakutan	aghast(p), appalled, dismayed, shocked
mengasihi	love
gali	Gali.
kebaikan	kindness, benignity
padamu	to you.
pipi	boldness, nerve, brass, face, cheek
slamet	Slamet
kulkas	refrigerator, icebox
umatnya	His people
teks	text, textual matter
loading	Loading
ngopo	Ngopo
ajaib	bizarre, eccentric, freakish, freaky, flaky, flakey, gonzo, off-the-wall, outlandish, outre
kesempatan	facility
tertawa	laugh, express joy, express mirth
tempo	vogue, trend, style
madu	honey
mencret	diarrhea, diarrhoea, looseness of the bowels, looseness
kertas	paper
crepes	Crepes
memberikan	render
pemandangan	appearance
slot	time slot, slot
enakan	preferably
mangkok	mug
teori-teori	Theory-theory
rara	Rara.
bijian	Grain
phone	Phone
diesel	Diesel
ironi	sarcasm, irony, satire, caustic remark
sumber	source
estetika	aesthetics, esthetics
kesan	tracing, trace
fenomena	phenomenon
neneknya	His grandmother
mangan	manganese, mn, atomic number 25
kerupuk	shrimp crisp
ali	catapult, arbalest, arbalist, ballista, bricole, mangonel, onager, trebuchet, trebucket
mencintai	love
yani	Yani.
candi	temple
min	mean, mean value
duck	Duck.
relaxing	Relaxing.
kenya	Kenya
bisakah	can
kegiatan	activity
masha	Masha
militer	military
mendukung	vouch
pihak	side
mw	Mw
majalah	magazine
diet	waste, emaciate, macerate
gunawan	noble
bunyinya	Ill
roof	Roof.
seputar	around
cuit	Cuit
hamster	hamster
pi	pi
nyebur	Nyebur
informasi	information, selective information, entropy
edo	Edo.
stuck	Stuck
ucapkan	talk, speak, utter, mouth, verbalize, verbalise
turunin	Aunt
sunyi	placid, quiet, still, tranquil, smooth, unruffled
lumba-lumba	dolphin
ketinggian	aggrandizement, aggrandisement, elevation
sifat	attribute
discord	Discord
magus	Magus
stainless	Stainless
pancing	Fishing rod
berharap	hope
cap	stamp
mina	myna, mynah, mina, minah, myna bird, mynah bird
nampak	appear
mengubah	alter, neuter, spay, castrate
senior	aged, elderly, older, senior
audio	audiometric
warung	booth, cubicle, stall, kiosk
ketinggalan	neglect, pretermit, omit, drop, miss, leave out, overlook, overleap
chennai	Chennai
garis	line
dendam	revengeful, vindictive, vengeful
sayangku	my darling
menjaga	guard
pir	pear
roads	Roads.
halte	stop
hitung	calculate, cipher, cypher, compute, work out, reckon, figure
tampil	come on stage
nini-nini	Granny's
bersama-sama	together
cm	Cm
abu	cinder, clinker
berikan	give
nasib	fatal, fateful
cang	taut, tight
naya	Naya
doni	Doni.
dihitung	calculated
bermaksud	plan
selatan	south
leher	neck, neck opening
sepupu	cousin, first cousin, cousin-german, full cousin
testimoni	Testimonial
meh	Meh.
sendal	chock, wedge
merak	peafowl, bird of juno
beku	freeze
gi	ghee
gosip	chitchat, chit-chat, chit chat, small talk, gab, gabfest, gossip, tittle-tattle, chin wag, chin-wag, chin wagging, chin-wagging, causerie
tertentu	definite
ganjil	curiously, oddly, peculiarly
stasiun	station
pelangi	rainbow
selebriti	Celebrity
indeed	indeed
sela-sela	interstice
berdasarkan	based on
encan	Veiling
kwon	Kwon
tni	TNI.
ngambilnya	take it
kekecilan	insignificance
voli	volley
kompos	compost
persis	exactly
tenggorokan	throat, pharynx
sakitnya	the pain
naura	Naura.
angela	Angela.
nantinya	Later
wireless	Wireless
ketombe	dandruff
lapangan	field
mungil	bantam, diminutive, lilliputian, midget, petite, tiny, flyspeck
fitri	pure
teriakan	Shouts
digendong	scarf
ultah	Ultah
ngangkat	lift
ikhlas	faithfully, dependably, reliably
poin	Poin
berbahaya	dangerous
puluh	Sentieth
bantuan	help, aid
motivasi	motivation
sekaligus	all of a sudden, all at once
didepan	in front of
tidak-tidak	No, no
kehilangan	disappearance, disappearing
tulang	bone
ado	Ado.
koin	coin
dulunya	once, formerly, at one time, erstwhile, erst
sekeluarga	family.
berfaedah	advantageous
akal	intend, mean, think
menyuruh	order, tell, enjoin, say
mungkinlah	Maybe
premium	premium, insurance premium
dana	contribution, donation
cry	Cry.
ngaruh	Light
nyamperin	Nyamperin
kara	hyacinth bean, bonavist, indian bean, egyptian bean, lablab purpureus, dolichos lablab
kubaca	I read
sesat	wide, astray
gemuk	fat
sio	Sio.
mania	mania, manic disorder
kepulauan	Island
tag	Tag
gereja	abbey
oleh-oleh	gift
melanjutkan	carry, extend
pet	Pet
kian	beget, get, engender, father, mother, sire, generate, bring forth
reggae	reggae
sembarangan	randomly, indiscriminately, haphazardly, willy-nilly, arbitrarily, at random, every which way
budiman	Budiman
aini	Aini
menyeramkan	scary
noda	stain
kelima	fifth, 5th
wilayah	provincial
spesies	kind, sort, form, variety
merasakan	find, feel
duet	duet, duette, duo
menambah	add
menghadap	confront, face up, face
looting	Looting
penyakit	diseased, morbid, pathologic, pathological
geng	gang, pack, ring, mob
tenaga	activity
melalui	proceed, go
aplikasi	application
vagina	vaginal
roy	Roy
sesungguhnya	actually, really
ninja	ninja
hadir	present
pingsan	faint, conk, swoon, pass out
lava	lava
bot	boat
adil	fairly, fair, clean
jengkol	Jengkol
rapat	meeting
meter	meter
menantang	challenge
koboan	Koboan.
kelar	notch, nick, snick
kirim-kirim	Send-send
tepi	peripheral
ikon	icon
simpen	Simpen
cacat	disabled
komedian	Comedian
pantang	abstinence
ronde	round
ejen	mediator, go-between, intermediator, intermediary, intercessor
wkwk	Wkwk.
ultimate	Ultimate
kiranya	kindly
budak	boy
m-san	M-San
mengingatkan	remind
mentok	muscovy duck, musk duck, cairina moschata
pic	pitch
ambilnya	Take it
staf	staff
backstabbing	Backstabbing.
klaim	claim
keknya	Kek
ketagihan	substance abuse, drug abuse, habit
peka	sensitive
lololo	Lololo
betawi	Betawi
vitamin	vitamin
yahya	Yahya
kontak	contact
pertamanya	First
tipis	reduce, melt off, lose weight, slim, slenderize, thin, slim down
rupanya	countenance, visage
sawah	field
laba-laba	spider
nelayan	fisherman, fisher
knapa	While
divisi	division
kelihatannya	apparently, seemingly, ostensibly, on the face of it
bergema	echo
mencium	kiss
game-nya	the game is
mata-mata	bobby
cincin	ring, band
bercerai	branch, ramify, fork, furcate, separate
mengganggu	torture, excruciate, torment
play-doh	Play-doh
setirnya	The steering wheel
terasa	felt
volt	volt, v
menyesal	deplore, lament, bewail, bemoan
bulannya	month
gadang	big(p), enceinte, expectant, gravid, great(p), large(p), heavy(p), with child(p)
bersalah	guilty, hangdog, shamefaced, shamed
takut-takut	shy
seiring	abreast
berakhir	end
karang	coral
bomnya	Bomb
dibully	Dibully
segel	seal, stamp
faktor	factor
virus	virus
genit	girlish
okey	okay, o.k., all right, alright
gay	homosexual, homophile, homo, gay
paruh	beak, bill, neb, nib, pecker
ngedit	Edit
cumi-cumi	squid
sembuh	bring around, cure, heal
percobaan	check, checkout, check-out procedure
tahap	step
dian	candle, taper, wax light
membutuhkan	need
bucket	Bucket
ditahan	barricade, block, blockade, stop, block off, block up, bar
sayangnya	unfortunately, unluckily, regrettably, alas
liar	wild
blok	group, grouping
mobilnya	His car
speakers	Speakers
trailer	trailer, house trailer
sial	unfortunate
keinginan	impulse, impulsion, impetus
iklan	advertising, publicizing
domba	sheep
global	global, planetary, world(a), worldwide, world-wide
liriknya	Lyrics
soda	sodium carbonate, washing soda, sal soda, soda ash, soda
perayaan	celebration, festivity
dinas	department, section
bensin	hydrocracking
tentara	united states army, us army, u. s. army, army, usa
perlahan	inert, sluggish, soggy, torpid
anggun	courtly, formal, stately
kumpulkan	Collect
berbohong	lie
jerami	bedding material, bedding, litter
benang	cotton
nutupin	Cut out
romantis	romanticize
temani	Accompany
punggung	back
hias	decorate, adorn, grace, ornament, embellish, beautify
target	target, butt
kura-kura	tortoise
joki	jockey
lonceng	bell
klasik	classical, classic
santet	Santet
kuntilanak	Kuntilanak
misi-misi	Mission
lebah	bee
sinari	Sinari
tusuk	Stick
patah	tire, pall, weary, fatigue, jade
pelan	slow
konyol	stupid
isya	Isha.
ina	Ina
canggih	advanced, sophisticated
demam	fevered
pandai	clever, cunning, ingenious
esa	one
pepaya	papaya
pakaian	dress, clothe, enclothe, garb, raiment, tog, garment, habilitate, fit out, apparel
apa-apanya	What
lot	lot
teka-teki	puzzle
fase	phase, stage
april	April
populer	popular
batang	bar
kumpulin	Collect
gergaji	compass saw
lebat	abundant
aduhai	Aduhai
sejati	genuine, echt
adu	complain, kick, plain, sound off, quetch, kvetch
terlebih	particularly, peculiarly, especially, specially
rokok	cigarette
teki	nutgrass, nut grass, nutsedge, nut sedge, cyperus rotundus
pasalnya	Because
mengakui	acknowledge, recognize, recognise, know
bangunan	building
ndan	Ndan
setidaknya	at least
stereo	stereo, stereophony, stereo system, stereophonic system
kapok	Kapok
sopir	driver
serai	titmouse, tit
jefri	Jefri.
panen	harvest, harvesting, harvest home
toksik	toxic
batuk	cough
sagu	sago
nyong	Nyong
elit	Elite
biasa-biasa	Ordinary
zazaazaria97	Zazaazaria97.
date	Date
ngawur	Ngawur
reni	Reni.
situasi	situation
skor	score, musical score
penduduk	resident
biologi	biology
petir	bombshell, thunderbolt, thunderclap
bbm	BBM
hiburan	refreshment, recreation
koyok	dog, domestic dog, canis familiaris
belalang	grasshopper, hopper
protes	protest, objection, dissent
salma	Salma
bosan	tire, wear upon, tire out, wear, weary, jade, wear out, outwear, wear down, fag out, fag, fatigue
kenongo	Kenongo
rangers	Rangers
sekali-sekali	occasionally, on occasion, once in a while, now and then, now and again, at times, from time to time
punten	Punten
mandiri	independent
bendera	flag
menurutmu	according to you
iya-iya	Yes yes
fasih	eloquent, facile, fluent, silver, silver-tongued, smooth-spoken
ram	hoop
bonus	bonus, fillip
kaleng	can, tin, tin can
valoran	Valorant
wakil	behalf
berbicara	communicate, intercommunicate
kaum	communal
hitungan	sum, total, totality, aggregate
sinar	light
ikut-ikutan	vogue
setel	suit, suit of clothes
manja	indulge, luxuriate
omen	Omen
kaktus	cactus
panel	control panel, instrument panel, control board, board, panel
ampas	marc
trauma	stabbing, wounding
memimpin	lead
skinnya	skin
panci	boilerplate
lingkaran	coil, spiral, volute, whorl, helix
bergabung	compound, combine
jurusan	way
banting	Banting
nambang	Nambangan
nampaknya	apparently, seemingly, ostensibly, on the face of it
menghilangkan	remove
cilik	little, small
ngebak	Wrapped
paulus	Paul.
tumor	tumor, tumour, neoplasm
gudang	repositing, reposition, storage, warehousing
telinga	ear
ngamuk	Valuent
gang	passage
menganggap	equal, match, equalize, equalise, equate
sas	Sas.
berantakan	disorganized, disorganised
gila-gila	bacchanalian, bacchanal, bacchic, carousing, orgiastic
tampak	appear
jelas-jelas	Obviously
praktis	practical
ramma	Ramma.
cenot	Cenot.
ketawa-ketawa	Laugh away
domain	region, realm
paginya	the morning
sia	drain
tepar	sleep
siaran	broadcast
saget	SAGET
kemaren	yesterday
coboy	Coboy
alami	nature
enak-enak	delicious
anata	Anata
utang	debt
korban	sacrifice
puyeng	Puyeng.
terhibur	amused, diverted, entertained
muara	mouth
wall	Wall
bioskop	cinema, movie theater, movie theatre, movie house, picture palace
hidungnya	His nose
menemani	accompany
menabung	save
kit	Kit
lupain	Lupain
harimau	tiger
chat-an	Chat
kemajuan	improvement
wulan	Wulan
duren	Duren.
selimut	blanket, cover
cermin	mirror
singkong	cassava, casava
genap	entire, full, total
kreativitas	creativity, creativeness, creative thinking
sopankah	Sopankah
berharga	cute, precious
ngeledek	mock
editing	editing
menteri	minister
tumit	heel
pecat	dismissal, dismission, discharge, firing, liberation, release, sack, sacking
pati	kernel, substance, core, center, centre, essence, gist, heart, heart and soul, inwardness, marrow, meat, nub, pith, sum, nitty-gritty
minna	Minna.
rapuh	brittle, brickle, brickly
tipu-tipu	Tipu-trick
mendekat	near, nigh, close
garam	strategic arms limitation talks, salt
kesalahan	error
merinding	shiver
tenda	camp, encamp, camp out, bivouac, tent
drum	drum, membranophone, tympan
ratus	hundred, one hundred, 100, c
kenyataan	realistic
arab	arab, arabian
camping	camping, encampment, bivouacking, tenting
ngajakin	Ngajakin
mutlak	absolute
bali	Bali
rata-rata	about, around
tidur-tidur	sleep
melati	jasminum, genus jasminum
kentut	fart, break wind
ria	cheerful
undur	retirement, retreat
setinggi	high
bapa	church father, father of the church, father
kuil	place of worship, house of prayer, house of god, house of worship
kuno	disused, obsolete
baku	standard
bertambah	come to, revive, resuscitate
ponsel	cellphone
barang-barangnya	Her belongings
mutiara	pearl
berlaku	Valid
nyeri	painful
masyaikh	head
bibir	lip
nyapa	Greetings
aryo	Aryo.
mengecek	check, checkout, check-out procedure
sajalah	alone
hafidz	Hafidz
kedai	retailing
mulanya	At first
tisu	tissue
sera	hurriedly, hastily, in haste
micin	Micin
perhatian	survey, study
agama	religion
tawar	starchy, stiff, buckram
oni	Oni
omega	omega
mel	mail, mail service, postal service, post
balon	balloon
factor	Factor
tidurin	Sleeping
gema	plangency, resonance, reverberance, ringing, sonorousness, sonority, vibrancy
kopling	clutch
cepu	anther
sedangkan	whereas
sosis	sausage
stored	Stored
reflek	Reflex
angan	think, cogitate, cerebrate
sociabuzz	Sociabuzz.
aroma	olfactory property, smell, aroma, odor, odour, scent
elektrik	Electrical
menikah	marry, get married, wed, conjoin, hook up with, get hitched with, espouse
ham	ham
gubuk	hovel, hut, hutch, shack, shanty
objek	object, physical object
tiduran	sleeping
makanlah	Meal
sebiji	Sebg.
kebangsaan	nationality
formal	formal
dibohongin	Lied
konco	friend, quaker
istimewa	meanwhile
cetakan	print, publish
aktivitas	activity
until	pellet
aamir	Aamir.
kitab	book, volume
kelewatan	delay, holdup
togel	Togel
ageng	Ageng.
menghitung	count, counting, numeration, enumeration, reckoning, tally
ati	liver
serat	serrate, serrated, saw-toothed, toothed, notched
spion	detective
condong	awry, amiss
digit	character, fiber, fibre
album	album
puncak	crest
objektif	objective
melewati	beyond
sekali-kali	Once-time
ngada-ngada	Ngada
menjelaskan	qualify, restrict
flat	apartment, flat
oven	microwave, microwave oven
terpaksa	have
jalanan	path, route, itinerary
sensitif	Sensitive
lek	lek
ngecat	Look
akik	loom
sepanjang	Throughout
bra	brassiere, bra, bandeau
menelepon	call, telephone, call up, phone, ring
tercinta	beloved, darling, dear
cukai	Excise
menghargai	value
bakti	service
aero	Aero
paus	whale
induk	dam
riau	Riau.
menangin	cry
selagi	while, piece, spell, patch
standar	standard, criterion, measure, touchstone
syekh	sheik, tribal sheik, sheikh, tribal sheikh, arab chief
mafia	organized crime, gangland, gangdom
sori	sorry
untukmu	for you
dikatain	Dikatin
mukena	Mukena
obeng	screwdriver
situs	web site, website, internet site, site
mangsa	apprehension, arrest, catch, collar, pinch, taking into custody
pendapat	vote
masyarakat	civil, civic
mencuci	bathe
capai	achieved
baikan	Bay
bersahabat	chummy, matey, pally, palsy-walsy
tekanan	press, pressure, pressing
sia-sia	vainly, in vain
kenangan	monumental
tradisional	traditional
agresif	aggressive
bersatu	compound, combine
opi	Opi.
harapan	hope
idul	Eid al-Eid
jatuh-jatuh	fall
debat	argue, reason
ciri	trait
seringnya	Often
putra	child
nyanyi-nyanyi	sing sing
dijemput	picked up
keok	squawk
sedia	already
krisis	crisis
gamer	Gamer
pantas	proper
berkat	blessing
semula	again, once again, once more, over again
wafel	waffle
pilot	aviator, aeronaut, airman, flier, flyer
bandel	stubborn, obstinate, unregenerate
arca	objet d'art, art object, piece
magnet	magnetic, magnetized, magnetised
rutin	routine
benteng	position, post, berth, office, spot, billet, place, situation
tumbuhan	plant, flora, plant life
cupang	hickey, love bite
mendorong	propulsion, actuation
metafisika	metaphysics
fisika	physics, natural philosophy
mayatnya	His body
hujannya	rain
galon	gallon
dibenarkan	allow, permit, tolerate
memutar	twisting
ke-3	the 3rd
termos	thermos, thermos bottle, thermos flask
menyatu	absorb
menginjak	tread
mengirim	look
tempatku	My place
mendadak	acute
hendak	intend, mean, think
adat	custom, usage, usance
kuningan	yellow, yellowish, xanthous
bangkit	get up, turn out, arise, uprise, rise
mejanya	His desk
okenya	Okay
tosca	Tosca
meninggalkan	leave, leave alone, leave behind
punk	bum, cheap, cheesy, chintzy, crummy, punk, sleazy, tinny
elegan	courtly, formal, stately
tega	Of
cenderung	lean
tebang	Collection
darahnya	His blood
sayap	wing
pesisir	Coastal
juara	champion, prizewinning
kamil	complete
sehari-hari	daily
lega	easing, easement, alleviation, relief
menyelamatkan	save
urus	transaction, dealing, dealings
berjuang	contend, fight, struggle
tugasnya	His job
busuk	spoil, go bad
muntah	vomit, vomit up, purge, cast, sick, cat, be sick, disgorge, regorge, retch, puke, barf, spew, spue, chuck, upchuck, honk, regurgitate, throw up
memohon	fall over backwards, bend over backwards
nanas	pineapple
bakat	giving, gift
lebih-lebih	remains
perjalanan	journey
harta	property
yao	Yao.
lembut	softly, quietly
diminta	Asked
mengetik	type, typecast
won	north korean won, won
sempit	narrow-minded, narrow
lunas	keel
minimal	minimal, minimum
ucapan	greeting, salutation
yin	Yin.
laporan	brief
hiasi	Decorate
malang	ill, badly
mendekati	approach, approaching, coming
rapi	effective, efficient
intan	lover
rakyat	public
ketek	monkey
cita	feeling
bersabar	calm
kelebihan	plus, positive
payah	difficult, hard
jagoan	stud, he-man, macho-man
genangi	Call
angkut	Transport
bohongin	Lying
susuk	human body, physical body, material body, soma, build, figure, physique, anatomy, shape, bod, chassis, frame, form, flesh
mewek	Mewek
kato	Kato.
lautan	oceanic
ideal	ideal
pengaruh	influence
pola	pattern
mengenal	acknowledge, recognize, recognise, know
gading	tusk
klien	client
dona	Dona
beo	Beo
sak	Sak.
pooh	Pooh.
silau	dazzle, bedazzle, daze
kasino	casino, cassino
kamus	wordbook
gusti	wrestling, rassling, grappling
lembur	overtime
ucapin	said
notifnya	Notification
berputar	turn
awam	publicly
cape	exhausted, spent
keris	kris, creese, crease
sudut	angular
dinding	rampart, bulwark, wall
seharian	daylong, all day long
produksi	production
mesra	steep, infuse
bolanya	ball
kebangkitan	rebellion, insurrection, revolt, rising, uprising
menemui	proceed, go
rukun	accommodate, reconcile, conciliate
cik	silver perch, mademoiselle, bairdiella chrysoura
kencing	make, urinate, piddle, puddle, micturate, piss, pee, pee-pee, make water, relieve oneself, take a leak, spend a penny, wee, wee-wee, pass water
tamborin	tambourine
tempura	tempura
gedang	big(p), enceinte, expectant, gravid, great(p), large(p), heavy(p), with child(p)
celengan	piggy bank, penny bank
gomawo	Gomawo
masakin	Masakin.
dihidupin	Liven up
kelaparan	starving
grafik	chart
teri	anchovy
tia	Tia
ran	Ran.
laki	husband, hubby, married man
taichan	Taichan
webnya	the web
angkernya	The haunnya
mutu	quality
cubit	pinch, tweak
labirin	labyrinthine
gitarnya	His guitar
saur	Saur
tendang	kick, boot, kicking
moto	motto, slogan, catchword, shibboleth
menilai	evaluate
websitenya	the website
rahmat	blessing, benediction
sepuh	old
lambat	late, belatedly, tardily
vaksin	vaccine
tongkol	corncob, corn cob
anis	anise, anise plant, pimpinella anisum
tyson	Tyson
rizal	Rizal
medis	medical
haus	thirsty
konsumsi	consumption, ingestion, intake, uptake
kemakan	Pulses
rewel	troublesome
tuan	babu, baboo
terutama	chiefly, principally, primarily, mainly, in the main
nyalakan	turn on
selai	marmalade
bagai	like
labu	gourd, calabash
tetangganya	neighbor
kapak	wing
khusyuk	captive, absorbed, engrossed, enwrapped, intent, wrapped
sedap	mouth-watering, savory, savoury
kamarnya	Room
vokal	Vocal
anemia	anemic, anaemic
anoa	Anoa.
ganas	bad, tough
sesaat	fleeting, fugitive, momentaneous, momentary
keliatan	plasticity
penjaga	Security
testi	Testi.
saudaraku	Brother
zebra	zebra
berhati-hati	argus-eyed, open-eyed, vigilant, wakeful
informatif	informative, informatory
inai	henna
upacara	ceremony
gen	Gene
meminta	request
tekek	deaf
merubah	change, alter, modify
evan	Evan.
nanya-nanya	ask
taman	ballpark, park
mitra	Mitra
lawak	jest, joke, jocularity
beruntung	golden, favorable, favourable, lucky, prosperous
nuklir	nuclear, atomic
batal	fault
sesudah	subsequently, later, afterwards, afterward, after, later on
kogoya	Kogoya
paksa	Forced
fajar	dawn, morning
bangsa	racial
pondok	booth, cubicle, stall, kiosk
kerjasama	cooperation
monitor	monitor, monitor lizard, varan
widya	Widya.
lidah	clapper, tongue
sumur	well
rupiah	rupiah
thread	Thread
gile	Gile.
mengajak	ask
legenda	caption, legend
seng	zinc, zn, atomic number 30
ekonomi	economic, economical
cucu	grandchild
menutup	benight, bedim
yunani	greece, hellenic republic, ellas
gear	gear, gear wheel, geared wheel, cogwheel
malu-malu	shy
henti	exhaust, discharge, expel, eject, release
efisien	effective, efficient
kekasihnya	His lover
ego	ego
tv-nya	TV
personal	personal
persiapan	homework, prep, preparation
berbahagia	regimentation
melepas	remove, take, take away, withdraw
ab	ab, av
pribadi	personal
langgeng	imperishable
rintik	dribble, drip, drop
minah	Minah.
saranghae	WL
turis	tourist
menari	dancing, dance, terpsichore, saltation
biskuit	cookie, cooky, biscuit
omongan	Touch
paman	uncle
rantai	chain
begadang	stay up late
jarang-jarang	rarely, seldom
menyelesaikan	regularize, regularise
langit-langit	canopy
televisi	television, television system
terdapat	gettable, getable, obtainable, procurable
sepatutnya	duly
amal	social welfare, welfare, public assistance
liga	league
kepanasan	warmth, warmness
bis	bus, autobus, coach, charabanc, double-decker, jitney, motorbus, motorcoach, omnibus, passenger vehicle
urea	urea, carbamide
pucat	pale, blanch, blench
melayang	soar
kecepatan	alertness, sharp-sightedness, on the qui vive
ringan	lighten, lighten up
platinum	platinum, pt, atomic number 78
penyanyi	singer, vocalist, vocalizer, vocaliser
dok	dock, dockage, docking facility
ozon	ozone
terbalik	back, backward
cita-citanya	his dreams
taktik	tactic, tactics, maneuver, manoeuvre
janggal	inept, tactless
cokelat	brown, brownness
puisi	poetic, poetical
maklum	understand
defensif	defensive
simpai	hoop, ring
spektrum	spectrum
berperang	contend, fight, struggle
sekop	scoop, scoop shovel
gravel	gravel, crushed rock
gasolin	gasoline, gasolene, gas, petrol
arwah	die, decease, perish, go, exit, pass away, expire, pass, kick the bucket, cash in one's chips, buy the farm, conk, give-up the ghost, drop dead, pop off, choke, croak, snuff it
buatan	artificial, contrived, hokey, stilted
bk	BK.
edan	brainsick, crazy, demented, disturbed, mad, sick, unbalanced, unhinged
aura	air, aura, atmosphere
mematikan	anesthetize, anaesthetize, anesthetise, anaesthetise, put under, put out
terdampar	stranded
umpan	bait
pesta	celebration, festivity
bakteri	bacteria, bacterium
boros	consume, squander, waste, ware
singlet	Singlet
tulus	sincere
catur	chess, chess game
tambahan	extra, additional
dirasa	Feeled
mercusuar	Lighthouse
kegelapan	dark
ketutup	closed
ganda	double
yul	Yul.
spastik	spastic
tip	tip
inti	substance
menambang	grok, get the picture, comprehend, savvy, dig, grasp, compass, apprehend
lolos	escape
rendang	shady, shadowed, shadowy, umbrageous
ido	Ido
mulia	honorably, honourably
medok	thick
raket	racket, racquet
meninju	punch, plug
kategori	category
konspirasi	conspiracy, cabal
keluargaku	My family
mancingnya	Its fishing
penakut	fearful, timorous, trepid
ambek	Amk
pancingannya	Paint
umpet	hide-and-seek, hide and go seek
bekal	provide, supply, ply, cater
studio	studio
horizon	horizon, view, purview
handuk	towel
kalau-kalau	potential, possible
nggak-nggak	no, no
akhirat	eternity, timelessness, timeless existence
jerapah	giraffe, camelopard, giraffa camelopardalis
baskom	basin
tonjok	punch, clout, poke, lick, biff, slug
mahasiswa	college student
pengertian	definition
gedean	Gedean
gunting	clip, clipping, snip
kilat	glitter, glisten, glint, gleam, shine
indra	king
berhubungan	communicate, intercommunicate
lam	getaway, lam
bolt	bolt
hela	Hella.
agaknya	presumably, presumptively
akurat	accurate
mark	mark, german mark, deutsche mark, deutschmark
mengumpulkan	rally, rallying
konser	concert
terlanjur	stumble, slip up, trip up
merusak	impair
fat	Fat
meningkat	get up, turn out, arise, uprise, rise
kaba-kaba	Kaba-kaba.
pasangan	match, mate, couple, pair, twin
dimanapun	everywhere
genius	ace, adept, champion, sensation, maven, mavin, virtuoso, genius, hotshot, star, superstar, whiz, whizz, wizard, wiz
telanjang	altricial
gril	Gril
menggoda	charm, influence, tempt
sidat	eel
tawas	alum
lutut	stifle, knee
november	november, nov
risiko	risk
plat	plate
berniat	contemplate
menentu	decide
yak	Yak.
sketsa	cartoon, sketch
teko	pot, flowerpot
pinjam	borrow
terpisah	distinct
adonan	dough
makai	Make
melulu	entirely, exclusively, solely, alone, only
beton	concrete
mistik	mysterious, mystic, mystical, occult, secret, orphic
digital	digital
laser	laser, optical maser
nila	indigo
beras	rice
bagaikan	like, similar
net-nya	Net
formasi	formation
modem	modem
greeting	Greeting
merekrut	recruit
resi	reception, receipt
berdarah	bloody, damn, all-fired
belas	compassion, pity
runtuh	break down, collapse
tan	long ton, ton, gross ton
bersin	sneeze
kecek	chew the fat, shoot the breeze, chat, confabulate, confab, chitchat, chit-chat, chatter, chaffer, natter, gossip, jaw, claver, visit
bidang	occupation, business, job, line of work, line
jatuhin	fall
mencekam	gripping
merata	spread, distribute
insan	Insan
papanya	his father
bah	flood
rek	Rek.
tengahnya	middle
menaruh	leave, leave alone, leave behind
mineral	mineral
meningkatkan	increase
joox	JOOX
pembawa	carrier, immune carrier
usus	intestinal, enteric, enteral
kuda-kuda	sawhorse
terkait	related, related to
keliling	approximately, about, close to, just about, some, roughly, more or less, around, or so
gurih	tasty
becek	moisture, wet
ajakan	invitation
bar	bar
visi	Vision
patuh	compliant
tawa	laughter
kaise	Kaise
akustik	acoustic, acoustical
polos	innocent, guiltless, clean-handed
pilek	cold, common cold
komposisi	ingredient
kristal	crystal
tanggapan	sensing, perception
mengarah	directing, directional, directive, guiding
basi	sour, rancid
raga	basket, field goal
trio	trio
patut	due
bening	crystalline, crystal clear, limpid, lucid, pellucid, transparent
gun	comb
kepanjangan	stretching
gunakan	Use
racun	poison
perahu	barge, flatboat, hoy, lighter
eniwei	Eniwei.
haid	menstrual, catamenial
mukjizat	miracle
damang	Damang.
belimbing	carambola, star fruit
pik	pick, plectrum, plectron
kastil	castle, castling
tekstur	constitution, composition, physical composition, makeup, make-up
penutup	cover, covering, screening, masking
mengalahkan	exhaust, wash up, beat, tucker, tucker out
panda	lesser panda, red panda, panda, bear cat, cat bear, ailurus fulgens
naluri	instinct, inherent aptitude
korean	Korean
nisan	gravestone, headstone, tombstone
nehe	Nehe
macan	tiger, panthera tigris
platform	platform
bilang-bilang	common purslane, pussley, pussly, verdolagas, portulaca oleracea
samar	ambiguous
10.00	10.00.
horornya	Horror
indigo	anil, indigo, indigotin
enteng	lightly
pengorbanan	forfeit, forfeiture, sacrifice
mengoleksi	gather, garner, collect, pull together
pengemudi	driver
gotong	Mutualize
seo	Seo.
terharu	touch, disturb
mencengangkan	perplex, vex, stick, get, puzzle, mystify, baffle, beat, pose, bewilder, flummox, stupefy, nonplus, gravel, amaze, dumbfound
kutip	pick, pluck, cull
pemakan	predator, predatory animal
gol	goal
historis	diachronic, historical
kurasa	I think
siang-siang	early
pas-pasan	Pasasan
jelajah	Browse
rekam	pigeonhole, stereotype, stamp
kerap	much, practically
subyek	subject
peleng	Poke
berlawanan	inverse, reverse
ledakan	burst, split, break open
untunglah	Fortunately
penjual	crier
cerpen	novelette, novella
ngebully	Ngebully
nadi	pulse, pulse rate, heart rate
bung	brother, comrade
darat	terrestrial
terdengar	sounded
peserta	contestant
sepenuh	full
mancing-mancing	Fishing
lapan	eight, 8, viii
obok-obok	Obok
spageti	spaghetti
restoran	restaurant, eating house, eating place, eatery
gombalin	Gombalin.
plaza	plaza, mall, center, shopping mall, shopping center, shopping centre
terletak	set
halaman	compound
sembelit	constipated
matamu	your eyes
penemu	finder, discoverer, spotter
1.00	1.00.
galih	Galih
panggilan	call, telephone, call up, phone, ring
jemaah	council
cemas	panicky, panicked, panic-stricken, panic-struck, terrified, frightened
timbul	brocaded, embossed, raised
lelaki	manfully, manly
roket	rocket
bangku	bench
ukuran	size
jek	jack
benua	uproot, extirpate, deracinate, root out
asap	reek, fume
hama	mite
kehendak	want, need, require
ion	ion
menghina	load, adulterate, stretch, dilute, debase
naskah	text, textual matter
pian	Pian
mengisi	fill
setiawan	firm, loyal, truehearted, fast(a)
turunkan	abdicate, renounce
nikmat	joy, delight, pleasure
horizontal	horizontal
desember	December
rehat	stay, remain, rest
tebak-tebakan	riddles
kesukaan	fun, merriment, playfulness
lahan	land
rasakan	feel
piala	cup, loving cup
roboh	fall
macau	Macau
alfa	alpha
output	output, yield
harian	daily
mumet	confused
smoking	Smoking
januari	January
puyuh	quail
pemutih	bleach
ialah	map, represent
nipis	thinly, thin
festival	festival, fete
natural	natural
tanjung	cape, ness
meteor	meteor
mengundang	invite, bid
undang-undang	law, practice of law
budi	seemliness, grace
canai	whetstone
etnis	ethnicity
sauna	sauna, sweat room
sejumlah	batch
berkumpul	accumulate, cumulate, conglomerate, pile up, gather, amass
pastikan	determine, find, find out, ascertain
sembilan	nine, 9, ix
waalaikum	Waalaikum
obor	torch
berisi	laden, oppressed
seumur	wholly, entirely, completely, totally, all, altogether, whole
ghaib	disappear, vanish, go away
penampakan	visual image, visualization, visualisation
puding	dumpling
ketuk	tap, pat, dab
keanehan	curio, curiosity, oddity, oddment, peculiarity, rarity
sniper	Sniper
pengingat	reminder
saluran	road
batak	batak
eka	single
betis	calf
aspek	aspect
menjangkau	reach, get through, get hold of, contact
sirih	betel, betel pepper, piper betel
abad	hundred, 100, c, century, one c
gurita	octopus
akar	root, tooth root
beracun	poisonous
tenggara	southeast, south-east, sou'-east
alkohol	alcohol, alcoholic drink, alcoholic beverage, intoxicant, inebriant
hulu	interior, midland, upcountry
raksasa	giant
hamba	yes
serang	hit, smash, smasher, strike, bang
tersedia	available
animasi	animation
membela	marketing
konteks	context, linguistic context, context of use
landak	hedgehog, erinaceus europaeus, erinaceus europeaeus
badut	clown, buffoon, goof, goofball, merry andrew
kepercayaan	ideological, ideologic
helikopter	helicopter
kumaha	Kumaha
bayu	Bayu.
bekerjasama	cooperation
menakutkan	atrocious, frightful, horrifying, horrible, ugly
cintaku	my love
kritis	critical
pegawai	labor, labour, working class, proletariat
uap	steam
dukuh	hamlet, crossroads
peran	loft, attic, garret
mula	causal agent, cause, causal agency
kekurangan	failure
sirkuit	circuit breaker, breaker
beting	sandbank
songong	uncivil, rude
amarah	angry
cakap	competent
mengecil	decrease, lessen, minify
agenda	agenda, docket, schedule
kaisar	emperor
materi	solder
menyaksikan	witness
ares	collar, nail, apprehend, arrest, pick up, nab, cop
mudah-mudahan	greatly
program	program, programme
pm2	PM2.
lensa	lens, lense, lens system
ais	ice-cold
ekspresi	expression, manifestation, reflection, reflexion
gabung	bunch, bunch up, bundle, cluster, clump
keduanya	second, secondly
rel	rail
menahan	preserve, keep
timbangan	measuring instrument, measuring system, measuring device
akses	access, approach
cimol	Cimol
sisir	comb
tembus	penetrate, perforate
pacaran	flirt, flirting, flirtation, coquetry, dalliance, toying
mengocok	mix, mix in
kumulonimbus	cumulonimbus, cumulonimbus cloud, thundercloud
urutan	order, ordering
impor	import
azzeta	Azzeta
buruan	pursuit, chase, pursual, following
pramuka	troop, scout troop, scout group
ponpon	Ponpon.
durian	durian, durion, durian tree, durio zibethinus
pulpen	ballpoint, ballpoint pen, ballpen, biro
ditempel	sticked
sotong	squid
cocoklogi	MemiLogi.
deskripsinya	Descriptions
elak	escape
grupnya	Group
vesti	Vesti.
melakukannya	Do it
rifai	Rifai
pulau-pulau	Islands
spesialis	specialist, specializer, specialiser
memegang	hold
difollow	DIFOLLOW
analog	analogue, analog, linear
malas	faineant, indolent, lazy, otiose, slothful, work-shy
tetanggaku	My neighbor
berhak	true(a), lawful, rightful(a)
prioritas	baby
terbatas	restrict, restrain, trammel, limit, bound, confine, throttle
mencatat	gain, put on
perapian	brazier, brasier
peluru	fastball, heater, smoke, hummer, bullet
havana	Havana
daus	Daus
bermasalah	problematic
melamun	blank, vacuous
terpilih	choose, prefer, opt
pemilik	own, have, possess
warnain	Warnain
dinaikin	Dinaikin.
penunggunya	His reception
faceting	Faceting
asparagus	asparagus
curah	Bulk
reptil	reptile, reptilian
jul	Jul.
selingkuh	corrupt
naksir	crush
menjalani	take, submit
asu	Asu.
pesona	hex, bewitch, glamour, witch, enchant, jinx
kanguru	kangaroo
wasting	Wasting
pipis	pee
perjuangan	struggle
punah	extinct
sintetis	synthetic
gempa	earthquake, quake, temblor, seism
dipikir	thoughtful
hakim	judiciary, bench
satria	knight
siswi	undergraduate, undergrad
promosi	discount, price reduction, deduction
warisan	inheritance, heritage
berkendara	driving
mens	Mens
angka-angka	numeral, numerical, numeric
pisah	rent, rip, split
ubi	whiting, merlangus merlangus, gadus merlangus
menentukan	finalize, finalise, settle, nail down
eksistensi	being, beingness, existence
kabupaten	county
nembus	Browse
sangka	think, believe, consider, conceive
maksimal	maximal, maximum
rekan	friend, quaker
kronis	chronic
februari	february, feb
omongin	Sorry
dinosaurus	dinosaur
amir	air force officer, commander
filenya	The file
rubah	fox
kedok	mask
inventori	Inventory
selebihnya	flood, overflow, outpouring
kilau	luminesce
sesama	peer, equal, match, compeer
komunitas	community
mengesalkan	embitter, envenom, acerbate
bedak	powder
berlangsung	along, on
senyuman	smile, smiling, grin, grinning
momentum	momentum
etos	Ethos
rahma	Rahma
aksen	stress, emphasis, accent
wali	guardian
tentangnya	About it
bermimpi	dream, daydream, woolgather, stargaze
demokrasi	democratic
menghindar	avoid
input	input
rendam	soak, soakage, soaking
pensil	pencil
lomba	race
disebutnya	He called
biji-bijian	semen, seed, seminal fluid, ejaculate, cum, come
elevator	Elevator
menyanyi	whistle, sing
rang	fallow
tara	even
emi	Emi.
gawat	critical
waduk	pond, pool
terkena	shoot, hit, pip
melupakan	obliterate, efface
slip	slip, slip of paper
obo	oboe, hautboy, hautbois
terlambat	late, belatedly, tardily
membahas	cover, wrap up
jelasnya	bad weather, inclemency, inclementness
mae	Mae.
tunggal	solo
tobat	repentance, penitence, penance
referensi	reference, cite
rekaman	recording
terdekat	nearest, nighest, closest
mono	infectious mononucleosis, mononucleosis, mono, glandular fever, kissing disease
omong	speak, talk
alamat	address
toge	seedling
pengikut	discipleship
selasa	tuesday, tues
pajak	pawn, soak, hock
gaul	Gaul.
kantong	bag
kari	curry
ajaran	education, instruction, teaching, pedagogy, didactics, educational activity
pemuda	young, youth
dagu	chin, mentum
pabrik	factory, mill, manufacturing plant, manufactory
dosa	transgression, evildoing
insaf	penitent, repentant
suit	suite
syah	shah, shah of iran
pagar	rail, rail in
istilah	word
sebaiknya	advisable
segaris	in a line
frekuensi	frequency, absolute frequency
ngekill	Ngekill
nangka	jackfruit, jak, jack
ulangan	encore
jumbo	elephantine, gargantuan, giant, jumbo
urung	fail, go bad, give way, die, give out, conk out, go, break, break down
utututu	Utututu
robotnya	His robot
berpindah	move
koma	coma, comatoseness
bibi	aunt, auntie, aunty
perbedaan	difference
dita	Dita
permai	beautiful
opah	grandma, grandmother, granny, grannie, gran, nan, nanna
rebus	boil
iseng-iseng	procrastinate, stall, drag one's feet, drag one's heels, shillyshally, dilly-dally, dillydally
melindungi	cover, wrap up
tebal	thick, thickly
potensi	potential, possible
junior	junior
berpisah	break, separate, split up, fall apart, come apart
balas	return
bakau	mangrove, rhizophora mangle
berganti	change
galeri	balcony
manfaat	profit, gain, benefit
ampere	amperage
mesiu	ammunition, ammo
rugi	lose, turn a loss
mempersiapkan	fix, prepare, set up, ready, gear up, set
penyesalan	ruefully, contritely, remorsefully
manggilnya	call him
kawasan	area
ciuman	kiss, buss, osculation
ban	crest
meriah	regimentation
museum	museum
niatan	intention
tergolong	inclusive
perintah	rule, harness, rein
gombalan	Gombalan
berjanji	promise, assure
sendiri-sendiri	alone, solo, unaccompanied
struktur	structure
kembar	identical, monovular
akhlak	behavior, behaviour, conduct, doings
format	format
butir	detail, item, point
trip	journey, journeying
piknik	picnic
perih	arduous, backbreaking, grueling, gruelling, hard, heavy, laborious, operose, punishing, toilsome
ginjal	kidney
reng	vulture
becak	pedicab, cycle rickshaw
nonstop	nonstop flight, nonstop
kolaborasi	collaboration, collaborationism, quislingism
netral	unattached, uncommitted
loyal	loyal
sultan	sovereign, crowned head, monarch
brimstone	Brimstone
dus	carton
isyarat	gesture
revolusi	revolution
kehangatan	heat, warmth, passion
kekalahan	capitulation, fall, surrender
kumbang	beetle
baris	alignment
menaklukkan	tame, chasten, subdue
kudu	sleepy, sleepy-eyed, sleepyheaded
siput	mollusk, mollusc, shellfish
asisten	assistant, helper, help, supporter
saudara-saudara	friend, quaker
alias	alias, a.k.a., also known as
terbiasa	habituate, accustom
memanggil	call
kiper	goalkeeper, goalie, goaltender, netkeeper, netminder
tajam	harsh, abrasive
atletik	sport, athletics
teliti	careful
span	tight
rekor	record
kerjaannya	work
cuti	vacation
metalindo	Metalindo.
dayungnya	Paddle
kakeru	Kakeru
torres	Torres
morysenpai	Morysenpai
jurus	directly, straight, direct
menebak	think, opine, suppose, imagine, reckon, guess
zoo	menagerie, zoo, zoological garden
intim	close
belut	eel
teras	burden
kuas	brush
wilson	Wilson
acak	random
bising	noisy
kayu-kayu	timber
bumbu	ingredient, fixings
sebutannya	Its designation
pilar	column, pillar
kritik	knock, criticize, criticise, pick apart
senam	gymnastics, gymnastic exercise
menyelam	submerge, submerse
maskot	mascot
sekilas	lightly, softly, gently
angsa	cackler
menyesuaikan	adjust, conform, adapt
ditranslate	Translate
balkon	balcony
pemimpin	chairmanship
cabai	pepper
receh	Dereh
aneka	assorted, various
aci	legal
melebur	unify, unite, merge
mengerjakan	exercise, work, work out
anehnya	Strangely
depresi	depression
bob	bouffant
sebagus	Sebagus
timah	tin, sn, atomic number 50
rasul	apostle
ditakuti	feared
bor	drill
memenuhi	brim
bantala	Bantala
menyapa	greet
osis	Ost
dira	Dira
dahan	arm, branch, limb
murai	robin, american robin, turdus migratorius
skeptis	agnosticism, skepticism, scepticism
analisis	analysis
serak	gruff, hoarse, husky
menerangi	light
selang	alternate
iqbal	Iqbal
liburan	vacationing
terjebak	entice, lure, tempt
spiral	coiling, helical, spiral, spiraling, volute, voluted, whorled, turbinate
mendatangkan	causal agent, cause, causal agency
cadangan	suggestion
niaga	trade, craft
ditangkap	get, catch, capture
langganan	custom
enggeh	yes
berbakti	vow
corak	shape, form
fauna	animal, animate being, beast, brute, creature, fauna
manusiawi	human
megah	glorious
asam	sourly
mengurus	administer, dispense
memutuskan	cut, cut off
cebong	tadpole, polliwog, pollywog
partai	party
menyerang	attack
kontennya	Content
ceria	beaming, beamy, effulgent, radiant, refulgent
membikin	make
serbuk	crumb
ore	ore
pendeta	abbot, archimandrite
metro	metro, tube, underground, subway system, subway
demen	like, similar
memperluas	exsert, stretch out, put out, extend, hold out, stretch forth
denah	diagram, plot
bertahun-tahun	long time, age, years
mustahil	incredible, unbelievable
bukit	hill
rumus	formula
atom	atomic
asas	basic
truknya	truck
menekan	engage
ngemeng	Fucking
mintanya	Mintanya
sinergi	Synergy
joker	joker
menyatakan	state
kuda-kudaan	horse-horse
kung	bark
tunggul	stump
gosok	rub, wipe
dil	dill, dill weed
habitat	habitat, home ground
onoh	Onoh
bersedih	sad
tttttttttt	Ttttttttt
tangkai	stalk, stalking
mempelajari	learn, larn, acquire
menembak	stamp out, kill
sekutu	allied, confederate, confederative
merekam	pigeonhole, stereotype, stamp
wajar	appropriate
rawan	emotional
tragis	tragic
terputus	Disconnect
hormat	courteous
kecut	afraid(p)
bingkai	border, adjoin, edge, abut, march, butt, butt against, butt on
musyrik	idolater, idolizer, idoliser, idol worshiper
terluka	cut
mengatasi	beyond
koala	koala, koala bear, kangaroo bear, native bear, phascolarctos cinereus
serah	submit, state, put forward, posit
dini	early
studi	study, hit the books
kebab	kabob, kebab, shish kebab
keton	ketone
senonoh	decent
cuma-cuma	gratis, for free, free of charge
poster	poster, posting, placard, notice, bill, card
temu	meet, encounter, play, take on
menghadapi	know, experience, live
menaiki	wax, mount, climb, rise
meloncat	leap, jump
nyenyak	heavy, profound, sound, wakeless
menempel	adhere
melon	melon
tentakel	tentacle
jenazah	carcase, carcass
encok	gout, gouty arthritis, urarthritis
melayani	service
cemerlang	glorious, resplendent, splendid, splendiferous
bordir	Embroidery
terbakar	sunburn, burn
campur-campur	assorted, miscellaneous, mixed, motley, sundry(a)
knot	nautical mile, mile, mi, naut mi, knot, international nautical mile, air mile
olah	caprice, impulse, whim
saksi	bystander
pasukan	brigade
kurnia	prize, award
kiwi	kiwi, apteryx
wayang	movie, film, picture, moving picture, moving-picture show, motion picture, motion-picture show, picture show, pic, flick
mencegah	break, break off, discontinue, stop
politik	politics
odin	Odin
janin	embryo, conceptus, fertilized egg
pembahasan	discussion
menentang	stare
padat	densely, thickly
blazer	blazer, sport jacket, sport coat, sports jacket, sports coat
susun	arrange, set up
mengajari	train
sebagian	approximately, about, close to, just about, some, roughly, more or less, around, or so
ubur-ubur	jellyfish
kumuh	dirty, soiled, unclean
mebel	furniture, piece of furniture, article of furniture
elektron	electron, negatron
ngilu	nerve-racking, nerve-wracking, stressful, trying
menguap	evaporate
menolak	vomit, vomit up, purge, cast, sick, cat, be sick, disgorge, regorge, retch, puke, barf, spew, spue, chuck, upchuck, honk, regurgitate, throw up
tegak	directly, straight, direct
urut	massage
dibiarkan	ignore, disregard, snub, cut
van	van
membara	burn
senyawa	compound
firman	commandment
sebaik	good
solar	solar
lela	elegant
kancil	napu, tragulus javanicus
subjek	subject, content, depicted object
sasageo	Sasageo
nutrisi	food, nutrient
serum	serum, blood serum
menyadari	understand, realize, realise, see
bros	brooch, broach, breastpin
las	welding
layah	concave
berturut-turut	continuous, uninterrupted
pegunungan	range, mountain range, range of mountains, chain, mountain chain, chain of mountains
berembuk	hash out, discuss, talk over
piramid	pyramid, great pyramid, pyramids of egypt
berkunjung	come
keberuntungan	profitableness, profitability, gainfulness, lucrativeness
bobot	cargo, lading, freight, load, loading, payload, shipment, consignment
ahlinya	God
butar	Butar.
penempatan	placement, location, locating, position, positioning, emplacement
pengambilan	appropriation
paradoks	paradox
terlentang	spread, overspread
konsol	console
gerobak	cart
seimbang	commensurate
tolak	push, pushing
tetet	Tetet.
mencerna	adopt, take in
mayones	mayonnaise, mayo
jasmine	Jasmine
berduri	barbed, barbellate, briary, briery, bristled, bristly, burred, burry, prickly, setose, setaceous, spiny, thorny
menginspirasi	inspiring
mon	Mon.
piton	reticulated python, python reticulatus
gulai	curry
teriyaki	teriyaki
terbenam	dress, arrange, set, do, coif, coiffe, coiffure
lori	car, railcar, railway car, railroad car
getaran	vibration, quiver, quivering
sampel	sample, try, try out, taste
syok	hilarity, mirth, mirthfulness, glee, gleefulness
mekar	blossom, blossom out, blossom forth, unfold
panggangan	broiler
skema	outline, schema, scheme
tiupin	Tiupin
puber	puberty, pubescence
hints	Hints.
ukir	describe, depict, draw
berencana	plan
desert	dessert, sweet, afters
mastering	Mastering
yard	yard
merk	brand, trademark, brandmark
kembang	wide, wide-cut, full
keterlaluan	extremely, exceedingly, super, passing
instrumen	instrument
menabrak	run down, run over
gembok	padlock
golf	golfing
kanji	singlet, vest, undershirt
mengadakan	stage
telapak	sole
diganggu	disquieted, distressed, disturbed, upset, worried
antartika	antarctic, antarctic zone, south frigid zone
perkembangan	development
stabil	stable
hok	hock, hock-joint
nahkoda	skipper
bokong	butt
yayasan	initiation, founding, foundation, institution, origination, creation, innovation, introduction, instauration
pembukaan	beginning, start, commencement
mengalir	menstruate, flow
tongkat	cane
tampan	fine-looking, good-looking, better-looking, handsome, well-favored, well-favoured
lowongan	vacancy
diturunin	Diturunin.
mengandung	have a bun in the oven, bear, carry, gestate, expect
akrilik	acrylic, acrylic resin, acrylate resin
kebodohan	faux pas, gaffe, solecism, slip, gaucherie
blues	blues
tarif	duty, tariff
nuri	parrot
vodka	vodka
stigma	mark, stigma, brand, stain
blokir	stymie, stymy
inu	Inu.
jeda	Pause
sewa	rent
kepang	braid, lace, plait
tuna	albacore, long-fin tunny, thunnus alalunga
kumis	beard, face fungus, whiskers
fatal	fatal
kondang	celebrated, famed, far-famed, famous, illustrious, notable, noted, renowned
datar	even
syariat	shariah, shariah law, sharia, sharia law, islamic law
suram	bleakly
relevan	relevant
juri	jury
keringat	perspiration, sweat, sudor
rawat	treat, care for
sarkasme	sarcasm
kalimatnya	sentence
salad	salad
jaket	jacket
kabut	obscure, befog, becloud, obnubilate, haze over, fog, cloud, mist
helmnya	Helm
reda	calm
mengendarai	ride
berlebihan	excessively, overly, to a fault, too
karir	career, life history
kuintal	hundredweight, cwt, short hundredweight, centner, cental, quintal
mempertaruhkan	count, bet, depend, look, calculate, reckon
profesi	profession
berbunyi	strike
aki	barrage, barrage fire, battery, bombardment, shelling
penulis	essayist, litterateur
sadap	wiretap, tap
menyiapkan	fix, prepare, set up, ready, gear up, set
kenaikan	lift, raise, heave
hutang	owe
lalat	fly
diskusi	discussion, treatment, discourse
ros	Ros.
dahsyat	bloody, damn, all-fired
lambung	pass, toss, flip
langka	rare
kun	binding
ruko	Ruko
terlepas	unblock, unfreeze, free, release
industri	industry, manufacture
duka	grief, sorrow
perak	silver, silvern, silvery
takluk	give way, yield
loket	locket
hiasan	cosmetic, enhancive
dibongkar	dismantled
yen	yen
pena	pen
erat	fast
seberang	across
gagah	audacious, brave, dauntless, fearless, hardy, intrepid, unfearing
garpu	branching, ramification, fork, forking
menolong	help, aid
kuis	quiz
sejenis	homogeneous, homogenous
pencipta	godhead, lord, creator, maker, divine, god almighty, almighty, jehovah
beruang	bear
pekan	market, marketplace, market place
kenang	remember, retrieve, recall, call back, call up, recollect, think
petugas	staff
mengontrol	monitor, supervise
terhenti	bog down, bog
tangis	shout, shout out, cry, call, yell, scream, holler, hollo, squall
seluler	cellular
wafer	wafer
terhitung	count, bet, depend, look, calculate, reckon
diskriminasi	discrimination, favoritism, favouritism
geli	delicate, ticklish, touchy
jerit	abuse, clapperclaw, blackguard, shout
ngelakuin	Ngelakuin
tttttttt	Ttttttt
tipu	trick, fast one
booster	Booster.
tabah	Tabah
lilit	wind, winding, twist
sepuluh	ten, 10, x
najis	feculent
bambu	bamboo
kedalaman	depth
relaksasi	relaxation, relaxation behavior
arif	eruditely, learnedly
memaafkan	excuse, condone
beristirahat	rest
mesjid	mosque
tirai	blind, screen
mengakhiri	close
kalium	potassium, k, atomic number 19
peraturan	regulation
memasuki	learn, study, read, take
cedera	hurt
bukan-bukan	absurd
diare	ulcerative colitis
bantal	cushion
forum	forum, assembly, meeting place
entitas	breathe, take a breath, respire, suspire
lalai	absent, absentminded, abstracted, scatty
beraksi	act, behave, do
aram	aram
teror	dystopia
inisiator	Inisiator
alhamdulillah	fortunately, fortuitously, luckily, as luck would have it
lunak	satiny, sleek, silken, silky, silklike, slick
bacaan	reading, meter reading, indication
kultur	culture
urine	urine, piss, pee, piddle, weewee, water
selanjut	extra, additional
terbuat	done, through, through with(p)
memasak	cooking, cookery, preparation
tekad	resolution
flora	plant, flora, plant life
menyakiti	hurt
tutur	speak, talk
pengambil	taker
nostalgia	nostalgia
sena	senna
merawat	manicure
ilah	deity, divinity, god, immortal
sembah	worship
pening	dizzy
angkasa	space, infinite
kapur	calcareous, chalky
terjaga	wake up, awake, arouse, awaken, wake, come alive, waken
iklim	climatic, climatical
lingkungan	spectrum
nisa	charwoman, char, cleaning woman, cleaning lady, woman
meraih	receive, get, find, obtain, incur
pari	elasmobranchii, subclass elasmobranchii, selachii, subclass selachii
seragam	undifferentiated, uniform
menyedihkan	depressing, cheerless, uncheerful
meledakkan	explode, irrupt
bisu	dumb, mute, silent
mencoba-coba	dabble, smatter, play around
pengumuman	bulletin
vertikal	vertical, perpendicular
seketika	momentarily, momently
jagung	corn, edible corn
istana	castle, castling
seksama	exact
impian	reverie, revery
stik	steak
kebanjiran	flood
sperma	semen, seed, seminal fluid, ejaculate, cum, come
vespa	motor scooter, scooter
ilustrasi	demonstrative, illustrative
jerawat	acne
moga-moga	hopefully
tenis	tennis, lawn tennis
menghalau	rout, rout out, expel
petik	choice, selection, option, pick
tabung	cylindrical, cylindric
mengusir	exhaust, discharge, expel, eject, release
imam	imam, imaum
meremehkan	diminish, belittle
cemburu	possessive
konsentrasi	bayonet
pertarungan	fight
kebenaran	coincidentally, coincidently
sediakan	fix, prepare, set up, ready, gear up, set
berbagi	sharing
gulung	reel, scottish reel
lazim	common
potongan	decrease, diminution, reduction, step-down
usul	suggestion
periode	year
mentari	sun, sun
menanam	impregnate, infuse, instill, tincture
biro	office, business office
rekrut	recruit
dakwah	da'wah, dawah
wijen	sesame seed, benniseed
tinjauan	survey, study
hanyut	adrift(p)
berdaya	breathe, take a breath, respire, suspire
pidato	address, speech
hijab	head covering, veil
berbaik	approach, near, come on, go up, draw near, draw close, come near
pamer	display, exhibit, showing
modal	model, simulate
ben	ben
berdekatan	nearby
sejuk	balmy, mild, soft
mutasi	mutation, genetic mutation, chromosomal mutation
suki	abundant
lukisan	portrayal, characterization, enactment, personation
sembarang	any(a), whatever, whatsoever
menangkap	catch, grab, snatch, snap
token	token
semestinya	inevitably, necessarily, of necessity, needs
akibatnya	consequently, accordingly
panitia	committee, commission
kepekaan	reflex, reflex response, reflex action, instinctive reflex, innate reflex, inborn reflex, unconditioned reflex, physiological reaction
kemal	damp, dampish, moist
aktor	actor, histrion, player, thespian, role player
pencari	finder, viewfinder, view finder
pentas	dais, podium, pulpit, rostrum, ambo, stump, soapbox
berpengalaman	salt
wani	brave, courageous
merayakan	feast, banquet, junket
spektakuler	dramatic, spectacular, striking
pelit	meager, meagre, meagerly, stingy, scrimpy
sinopsis	summary, sum-up
pengetahuan	cognition, knowledge, noesis
tinjau	research
kerajaan	government, governing, governance, government activity, administration
pokok	plant, flora, plant life
memainkan	play
sedunia	cosmopolitan, ecumenical, oecumenical, general, universal, worldwide, world-wide
siku	elbow
radar	radar, microwave radar, radio detection and ranging, radiolocation
sakti	charming, magic, magical, sorcerous, witching(a), wizard(a), wizardly
pindahan	Pope
penyembuhan	healing
kornet	cornet, horn, trumpet, trump
toyib	Toyib
lisensi	license, licence, permit
babak	sequence, episode
keseimbangan	balance
periodik	periodic, periodical
security	Security
rekomendasi	recommendation, testimonial, good word
membeku	freeze
konferensi	conference
kepribadian	personality
fail	file, file cabinet, filing cabinet
julia	Julia
kunyah	chew, chewing, mastication, manduction
mempermudah	facilitate, ease, alleviate
kampret	carnivorous bat, microbat
nota	note
tertib	polite
buncis	pulse
stadium	stadium, bowl, arena, sports stadium
audit	audit
kadar	merely, simply, just, only, but
ombak	wave
dikobok	Burdy
menghabiskan	scavenge, clean
cctv	CCTV
jemuran	clothesline
kon	cone
lekas	expeditious
bercerita	yarn
pemakaman	burial
menempuh	digest, endure, stick out, stomach, bear, stand, tolerate, support, brook, abide, suffer, put up
client	Client
gelisah	distraught, overwrought
tebakan	puzzle
salahin	Wrong
membosankan	tire, wear upon, tire out, wear, weary, jade, wear out, outwear, wear down, fag out, fag, fatigue
tingkah	caprice, impulse, whim
kesayangan	beloved, darling, dear
guguk	Guguk.
perkataan	word
anion	anion
serigala	wolf
bermanfaat	advantageous
boya	buoy
dukun	marabou, marabout, marabou stork, leptoptilus crumeniferus
gel	gel, colloidal gel
risau	flustered, hot and bothered(p), perturbed, rattled
kesemuanya	wholly, entirely, completely, totally, all, altogether, whole
menanti	expect, look, await, wait
selaku	equally, as, every bit
menjauhkan	estrange, alienate, alien, disaffect
panggang	broil, broiling, grilling
kembang-kempis	Kempis
marsya	Marsya
pedayung	Pedayung
bokongmu	Your buttocks
riza	Riza
menjauhi	avoid
lincah	agile, nimble, quick, spry
pianonya	piano.
lemak	fatty, fat
selangit	extraordinary
kontes	contest
mv	MV.
kutub	polar
enden	Enden
salem	atlantic salmon, salmo salar
denai	track, cart track, cartroad
denda	punishment, penalty, penalization, penalisation
kepentingan	sake, interest
menderita	trouble, ail, pain
pendidikan	education
tegas	firm, firmly, steadfastly, unwaveringly
buku-buku	books
bergantung	contingent, contingent on(p), contingent upon(p), dependent on(p), dependant on(p), dependent upon(p), dependant upon(p), depending on(p)
fobia	phobic
bp	BP.
menjangan	deer, cervid
bata	brick
menengah	middle
gangster	gangster, mobster
santa	ideal, paragon, nonpareil, saint, apotheosis, nonesuch, nonsuch
kesiangan	oversleep
perilaku	behavior, behaviour
tender	bid, tender
korporat	bodied, corporal, corporate, embodied, incarnate
mengenali	acknowledge, recognize, recognise, know
orde	order
radionya	Radio
pager	beeper, pager
memotivasi	motivate, actuate, propel, move, prompt, incite
manik	bead
culik	abduct
bambang	across-the-board, all-embracing, all-encompassing, all-inclusive, blanket(a), broad, encompassing, extensive, panoptic, wide
piket	lookout, lookout man, sentinel, sentry, watch, spotter, scout, picket
menyumbang	marketing
arifin	wise
mengucapkan	draw, make
kendali	bridle
bersamaan	arterialize, arterialise
makmur	boom, thrive, flourish, expand
yuyu	crab
encer	dilute, thin, thin out, reduce, cut
modar	die, decease, perish, go, exit, pass away, expire, pass, kick the bucket, cash in one's chips, buy the farm, conk, give-up the ghost, drop dead, pop off, choke, croak, snuff it
gambaran	representation
tercium	stray, err, drift
ti	ti, te, si
belanda	Dutch
menceritakan	tell
grosir	wholesale
gores	slash, gash
lupus	lupus
akrobatik	acrobatic, athletic, gymnastic
niggato	Niggato
kalung	chain, string, strand
amankah	Securely
seterusnya	henceforth, henceforward
sebaliknya	rather, kind of, kinda, sort of
sadis	sadistic
kudus	holy
pil	pill, lozenge, tablet, tab
syarat	circumstance, condition, consideration
terkejut	jolted, shaken
yeye	Yeye
pewarna	color, colour, emblazon
demit	Demit
berkembang	grow, develop, produce, get, acquire
minimum	minimal, minimum
kakao	cacao, cacao tree, chocolate tree, theobroma cacao
definisi	definition
kerjakan	perform, execute, do
jahit	sew, run up, sew together, stitch
mengadu	complain
mistis	mystic, mystical
memuji	praise
sani	honorable, honourable
membingungkan	bewilderingly, confusingly
dosanya	His sin
plak	brass, memorial tablet, plaque
akrab	close
bayangkan	Imagine
injeksi	injection
bibit	dawn
pengguna	consumer
haram	illegal
meminum	Drink
seakan2	As if
desainer	architect, designer
menjalin	tie, bind
sonata	sonata
trims	TRIMS.
skala	balance
cerewet	awkward, embarrassing, sticky, unenviable
menutupi	cover, wrap up
aib	flaw, blemish
oknum	personality
sagu-sagu	Sago-sagu.
koneksi	connection
panennya	Harvest
speknya	Specify it
melahirkan	parturient
bujangan	bachelor, unmarried man
penyok	bent, crumpled, dented
kutukan	disapprobation, condemnation
peternak	breeder, stock breeder
optimis	optimistic
guling	roll, bowl
mahir	breathe, take a breath, respire, suspire
reffnya	Reff
lorong	aisle, gangway
lobster	lobster
menepati	carry through, accomplish, execute, carry out, action, fulfill, fulfil
upaya	attempt, effort, endeavor, endeavour, try
suasana	air, aura, atmosphere
loyang	brazen
kaunter	bar
abses	dermatomyositis
membagi	fail, go bad, give way, die, give out, conk out, go, break, break down
melengkapi	rig, set, set up
terburu-buru	brash, cheeky, nervy
retak	snap, crack
tantangan	challenge
menyampaikan	give
mengimbau	appeal, invoke
berurusan	reach, get through, get hold of, contact
mengajarkan	teach
debu	deflation
denting	band, ring
aba	church father, father of the church, father
komunikasi	communication
busa	foam, froth, fizz, effervesce, sparkle, form bubbles
renyah	finical, finicky, fussy, particular, picky
mengucap	note, observe, mention, remark
membayangkan	visualize, visualise
berdamai	accommodate, reconcile, conciliate
serangan	attack, tone-beginning
ikat	tie
tertinggi	sovereign, supreme
keenam	sixth, 6th
pertemuan	convergence, converging, convergency
tal	palmyra, palmyra palm, toddy palm, wine palm, lontar, longar palm, borassus flabellifer
bertugas	serve
kapas	downy, downlike, flossy, fluffy
kejahatan	atrocity, inhumanity
berkarya	make, create
teratur	dapper, dashing, jaunty, natty, raffish, rakish, spiffy, snappy, spruce
dengki	malicious
oren	orange, orangish
tertidur	snooze, drowse, doze
baginda	sire
karantina	quarantine
organisasi	constitution, establishment, formation, organization, organisation
harmoni	harmonious
profesor	professorship, chair
kriteria	criterion, standard
ancaman	endanger, jeopardize, jeopardise, menace, threaten, imperil, peril
sehabis	wholly, entirely, completely, totally, all, altogether, whole
hoya	wax plant, hoya carnosa
efektif	effective
nara	Nara
koper	baggage
ohm	ohm, georg simon ohm
terkubur	die
beranak	wear, bear
tonggak	column, pillar
buat-buat	water bottle
krusial	crucial, important
memenangkan	win
satir	Satir
iblis	demonic, diabolic, diabolical, fiendish, hellish, infernal, satanic, unholy
mengecewakan	frustrating
halus-halus	fine
tengkorak	carcase, carcass
budaya	cultural
dikatakan	allegedly
kukus	steam
saranghaeyo	Saranghaeyo
pemukiman	residential
balok	balance beam, beam
mesum	dirty, soiled, unclean
unsur	substance
seret	drag
pangkal	beginning, start, commencement
caci	abuse, clapperclaw, blackguard, shout
amunisi	ammunition, ammo
peluk	hug
trobos	Trobos
aulia	Aulia.
mendatangi	confront, face
berbentuk	shape, form
milo	milo, milo maize
kolot	conservative
ceng	syrup, sirup
menghancurkan	decompose, break up, break down
bijak	clever, cunning, ingenious
nyanyian	lullaby, cradlesong
setelan	suit, suit of clothes
ratusan	hundred, 100, c, century, one c
berawal	get down, begin, get, start out, start, set about, set out, commence
menonjol	bulge, pouch, protrude
bungkus	coat, surface
kening	frontal
terapi	therapy
makalah	article
separuh	partially, partly, part
tuduh	blame, fault
kalender	calendar
hg	hectogram, hg
regional	regional
licik	artful
amino	amino, aminic
eksklusif	entirely, exclusively, solely, alone, only
aloe	aloe
yogi	yogi
macho	butch, macho
kumpulan	group, grouping
tiup	blow, puff
mengurangi	reduce, melt off, lose weight, slim, slenderize, thin, slim down
hajar	wallop
mondok	fat
pemberani	unafraid(p), fearless
panji	standard, banner
memo	memo, memorandum, memoranda
kebocoran	escape, leak, leakage, outflow
kelopak	cartridge holder, cartridge clip, clip, magazine
serbu	attack, attempt
spesialisasi	specialization, specialisation, specialty, speciality, specialism
aren	sugar palm, gomuti, gomuti palm, arenga pinnata
pandu	drive, ride
pengakuan	adoption, acceptance, acceptation, espousal
berdiam	know, experience, live
bengek	futility
ramuan	ingredient
keunikan	singularity, uniqueness
inovasi	initiation, founding, foundation, institution, origination, creation, innovation, introduction, instauration
rawa	bog, peat bog
menghabisi	finish up, land up, fetch up, end up, wind up, finish
genting	critical
bertinju	box
elok	beneficial, good
terbesar	large, big
berak	excrete, egest, eliminate, pass
koloni	colonial, compound
menara	keep, donjon, dungeon
homo	homosexual, homophile, homo, gay
tenun	weave, tissue
penggemar	fanatic, fanatical, overzealous, rabid
pengasih	thoughtful
mual	gag, heave, retch
inci	fathom, fthm
mengira	presume
ciput	penis, phallus, member
mengetes	test, prove, try, try out, examine, essay
pincang	crippled, halt, halting, lame, gimpy, game
kelelawar	bat, chiropteran
empedu	bile, gall
kokoh	uncompromising, sturdy, inflexible
berkenan	approve
insomnia	insomnia
jamin	undertake, guarantee
manggis	mangosteen
universal	catholic
menjebak	frame, compose, draw up
umat	people
mencakup	cover, wrap up
giling	crushed
elektronik	electronic
ketiak	armpit, axilla, axillary cavity, axillary fossa
bersihkan	cleanse, clean
ternak	livestock, stock, farm animal
klinik	clinic
permanen	permanent, lasting
menjinakkan	domesticate, tame
setetes	Drop
peri	spirit world
bobrok	dilapidated
seorangnya	One
memuat	load
rempah-rempah	spice
teripang	sea cucumber, holothurian
marlin	black marlin, makaira mazara, makaira marlina
konkrit	concrete
berteduh	hide, hide out
subscene	Subscene
antagonis	antagonist
wesel	weasel
anggur	idle, jobless, out of work
pirang	blond, blonde, light-haired
celeng	boar
sulam	embroider, broider
sekejap	briefly
lai	pear, pear tree, pyrus communis
garong	robber
menyandang	bear, hold
tiara	tiara
teluk	bay, embayment
konsisten	consistent
utk	function, purpose, role, use
carikan	tear
undang	invite, ask over, ask round
latif	beautiful
judes	choleric, irascible, hotheaded, hot-tempered, quick-tempered, short-tempered
tekstil	textile
kerasukan	entrance, spellbind
tasik	lake
pigmen	pigment
luang	gap, crack
berkabut	mist, mist over
kontrak	contractual
injil	bible
lb	pound, lb
badminton	badminton
melukis	disembowel, eviscerate, draw
lengan	foreleg
rohnya	His spirit
pucuk	shoot, spud, germinate, pullulate, bourgeon, burgeon forth, sprout
biologis	biological
menengok	determine, check, find out, see, ascertain, watch, learn
kualitas	direct, unmediated
kedap	impermeable
rak	cabinet
menunjuk	sharpen, taper, point
disambut	welcome, receive
pasiennya	patients
corong	funnel
cebol	dwarf, midget, nanus
ultra	Ultra
tuang	pour
berdiskusi	hash out, discuss, talk over
mahkota	coronet
binal	disobedient
elastis	elastic
unggul	distinguished
sensasi	sensational
jenggot	beard, face fungus, whiskers
benih	embryo, conceptus, fertilized egg
pemancing	angler, troller
pernyataan	argument, statement
edukasi	education, instruction, teaching, pedagogy, didactics, educational activity
lesu	tire, wear upon, tire out, wear, weary, jade, wear out, outwear, wear down, fag out, fag, fatigue
etika	ethical, honorable, honourable
saringan	filter
goda	enticement, temptation
gurau	joke, jest
yeti	abominable snowman, yeti
samar-samar	vaguely, mistily
sangkut	hang, hang up
safa	white
tangkap	apprehension, arrest, catch, collar, pinch, taking into custody
berdampingan	collaborate, join forces, cooperate, get together
berdebar-debar	exhaust, wash up, beat, tucker, tucker out
pelita	lamp
kampus	campus
jenis-jenis	kind, sort, form, variety
menjerit	bawl
gaun	dress, frock
keriting	curl, curve, kink
apartemen	apartment, flat
jata	coat of arms, arms, blazon, blazonry
mengalah	give way, yield
kedipan	blink, eye blink, blinking, wink, winking, nictitation, nictation
misil	missile
juru	expert
subur	exuberant, lush, luxuriant, profuse, riotous
letusan	burst, split, break open
hina	atrocious, frightful, horrifying, horrible, ugly
sekiranya	in case, just in case
zoro	Zoro.
menular	infect
agustus	august, aug
derik	cut
menendang	kick
rim	rim
petinju	boxer, pugilist
menghafal	learn, study, read, take
rusa	deer, cervid
jenderal	general officer
sandal	sandal
spontan	ad-lib, spontaneous, unwritten
donor	donor, giver, presenter, bestower, conferrer
menggila	feverish, hectic
haruskah	Should it
meletus	explode, burst
menghemat	save, make unnecessary
ustaz	overlord, master, lord
pemula	starter, starter motor, starting motor
sedikit-sedikit	gradually, bit by bit, step by step
membakar	inflame
kejam	atrocious, frightful, horrifying, horrible, ugly
susunan	order
beradu	sleep, kip, slumber, log z's, catch some z's
mil	meal
hadap	face
kapa	kappa
dasi	bow, bowknot
fondasi	foundation
kebanyakannya	chiefly, principally, primarily, mainly, in the main
minim	minimal, minimum
menyangkut	hitch, catch
anggrek	orchidaceae, family orchidaceae, orchid family
kincir	bobbin, spool, reel
dihukum	sentence, condemn, doom
melarikan	kidnap, nobble, abduct, snatch
penghuni	resident
memandang	fix
sut	suit, suit of clothes
engkol	crank, starter
monokrom	black and white, monochrome
cadel	lallation
rito	Rito
gocek	Gocek
kol	calculate, estimate, reckon, count on, figure, forecast
dame	Dame
seko	detective
naif	inexperienced, inexperient
akson	axon, axone
produktif	fat, fertile, productive, rich
mantel	cape, mantle
bertengkar	contend, postulate
disuruh-suruh	Bean told
kecantikan	beauty
organ	electric organ, electronic organ, hammond organ, organ
lereng	gradient, slope
asuh	train, develop, prepare, educate
selepas	subsequently, later, afterwards, afterward, after, later on
meletakkan	bring, land
tetua	freckle, lentigo
berdosa	iniquitous, sinful, ungodly
sarana	medium
jung	junk
gejala	syndrome
buntut	butt, butt end
tua-tua	head
tuntutan	demand
larut	far
menguli	massage, rub down, knead
psikologi	psychological
prinsip	rationale, principle
ndasmu	Ndasmu.
kecambah	sprout
pengalihan	motion, movement, move
wealth	Wealth
komplit	complete
lena	inattentive
jangka	compass
harum	beautiful
mengolah	process, treat
puri	castle
siksa	maltreatment, ill-treatment, ill-usage, abuse
menyembah	idolize, idolise, worship, hero-worship, revere
antena	antenna, aerial, transmitting aerial
davina	Davina
mereka-mereka	They are
terdiam	placid, quiet, still, tranquil, smooth, unruffled
gangguan	intrusion
terbangun	wake up, awake, arouse, awaken, wake, come alive, waken
asi	lawful
kebolehan	bore, gauge, caliber, calibre
lumut	moss
seminar	seminar
kursor	cursor, pointer
daki	climb, climb up, mount, go up
baton	baton
haiku	haiku
bengkok	awry, amiss
kedatangan	arrival
insiden	incident
menelan	swallow
berendam	soak
penutupan	termination, ending, conclusion
sebutan	designation, identification
terulang	repeatedly
cukur	shave
berlanjut	continue, go on, proceed, go along, keep
kemaluan	penis, phallus, member
berasal	earlier, before
keterangan	explanatory
pepatah	saying, expression, locution
teater	theatrical
republik	state, nation, country, land, commonwealth, res publica, body politic
sembari	concurrently, at the same time
kandungan	constitution, composition, physical composition, makeup, make-up
remeh	petty, small-minded
melompat-lompat	play, frolic, romp, gambol, caper
modis	fashionable, stylish
taruhan	bet, wager
sigma	sigma
kenari	canary, canary bird
candu	opium
rana	brave, courageous
keuangan	fiscal, financial
atlas	satin
menginginkan	want
erosi	corrosion, corroding, erosion
ngomonglah	Speaking
mingguan	weekly, hebdomadal, hebdomadary
saleh	pious
mengangkat	shrug
picu	gun trigger, trigger
abadi	everlastingly, eternally, forever, evermore
pekat	gluey, glutinous, gummy, mucilaginous, pasty, sticky, viscid, viscous
aksara	character, fiber, fibre
urgen	pressing, urgent
keberatan	reluctantly
tandai	mark
berbuat	act, behave, do
manjur	effective, effectual, efficacious
larva	larvacean
bulu-bulu	fluff
ketat	tight
dering	ring, peal
kemeja	shirt
cegah	prevent, forestall, foreclose, preclude, forbid
rima	rhyme, rime
pandangan	estimate, estimation
terong	ratatouille
puting	comforter, pacifier, baby's dummy, teething ring
enzim	enzyme
gatal-gatal	itch
berminyak	greasy, oily
terminal	terminal
emosional	emotional
flu	influenza, flu, grippe
triliun	trillion, one million million, 1000000000000
terus-menerus	indefinitely
tian	fetus, foetus
kompetitif	competitive, militant
kopiah	cap
menguak	die, decease, perish, go, exit, pass away, expire, pass, kick the bucket, cash in one's chips, buy the farm, conk, give-up the ghost, drop dead, pop off, choke, croak, snuff it
tornado	tornado, twister
orkes	band
teknis	technical
mendung	shady, shadowed, shadowy, umbrageous
mandarin	mandarin, mandarin chinese, mandarin dialect, beijing dialect
kerudung	headscarf
tukar	interchange, tack, switch, alternate, flip, flip-flop
terjangkau	gettable, getable, obtainable, procurable
perairan	body of water, water
pneumonia	pneumonia
pinang	betel palm, areca catechu
transisi	passage, transition
kicauan	warbler
fesyen	manner, mode, style, way, fashion
mengenang	remember, retrieve, recall, call back, call up, recollect, think
lipstik	lipstick, lip rouge
banjir	afloat(p)
melawak	joke, jest
bergoyang	shake, didder
sabit	certain, sure
pesantren	pesantran, pesantren
kebanggaan	pride
alur	channel
kental	firm, strong
liur	saliva, spit, spittle
lumpur	treacle, golden syrup
pesanan	procurement, procurance, procural
rani	rich
potret	photograph, photo, exposure, picture, pic
sesekali	occasionally, on occasion, once in a while, now and then, now and again, at times, from time to time
baja	steel
mengganti	change
temuan	discovery, find, uncovering
meregang	stretch
sekeliling	around
abnormal	unnatural
kesedihan	gloominess, lugubriousness, sadness
setara	adequate, equal
masakan	never, ne'er
sewot	resentful
berusia	age
pd	palladium, pd, atomic number 46
bon	reception, receipt
sebagaimana	like, same
pengurus	administrator, executive
keturunan	familial, genetic, hereditary, inherited, transmitted, transmissible
mengungguli	surpass, outstrip, outmatch, outgo, exceed, outdo, surmount, outperform
menetapkan	gear, pitch
gerakan	knock, belt, rap, whack, whang
seleksi	selection
perumahan	residential
memahami	grok, get the picture, comprehend, savvy, dig, grasp, compass, apprehend
berputar-putar	revolve, go around, rotate
pandang	think, believe, consider, conceive
sorak	cheer
membentuk	make, urinate, piddle, puddle, micturate, piss, pee, pee-pee, make water, relieve oneself, take a leak, spend a penny, wee, wee-wee, pass water
kondom	condom, rubber, safety, safe, prophylactic
jaksa	prosecutor, public prosecutor, prosecuting officer, prosecuting attorney
pecut	whip, lash
konsumen	consumer
menjadikan	make, urinate, piddle, puddle, micturate, piss, pee, pee-pee, make water, relieve oneself, take a leak, spend a penny, wee, wee-wee, pass water
berfikir	mentally
riwayat	history
sinting	lean, tilt, tip, slant, angle
bel	bell
heroik	heroic
azab	hapless, miserable, misfortunate, pathetic, piteous, pitiable, pitiful, poor, wretched
konvensional	conventional
brokoli	broccoli
satpam	watchman, watcher, security guard
majnun	lunacy, madness, insaneness
abdi	slave
makaroni	macaroni
sentosa	placid, quiet, still, tranquil, smooth, unruffled
pulih	recuperate, recover, convalesce
poker	poker, poker game
semak-semak	scrub, chaparral, bush
siaga	alert, watchful
membersihkan	cleanse, clean
desing	ping
menyedot	inhale, inspire, breathe in
dukungan	fumble
dermawan	charitable
anugerah	bounty, h.m.s. bounty
antik	antique
pernapasan	breathing, external respiration, respiration, ventilation
permintaan	call option, call
gabungan	combination, combining, compounding
penyelam	loon, diver
pundak	shoulder
serupa	similarly, likewise
ketukan	knock, knocking
pantulan	bounce, bounciness
pupus	disappear, vanish, go away
berlatih	train
vandal	vandal
risih	afraid(p)
menembus	break through, come through
salin	duplicate, matching, twin(a), twinned
mengurung	seclude, sequester, sequestrate, withdraw
sumo	sumo
bergaya	flashy, gaudy, jazzy, showy, sporty
lazimnya	largely, mostly, for the most part
ekstra	inordinately, extraordinarily
cip	chip, microchip, micro chip, silicon chip, microprocessor chip
biodata	biography, life, life story, life history
berkelana	digress, stray, divagate, wander
borong	wholesale
sir	mysterious, mystic, mystical, occult, secret, orphic
bina	build
rahim	uterine
bergelut	contend, fight, struggle
pastel	pastel
gemetar	tremble
menoleh	carom
kehebatan	glory, resplendence, resplendency
bereaksi	react
menegangkan	tense, strain, tense up
melempar	confuse, throw, fox, befuddle, fuddle, bedevil, confound, discombobulate
memikirkan	remember, retrieve, recall, call back, call up, recollect, think
ira	grain
peristiwa	event
retina	retinal
intens	intense
meresap	exude, exudate, transude, ooze out, ooze
peperangan	struggle, battle
permulaan	beginning, start, commencement
waria	sissy, pantywaist, pansy, milksop, milquetoast
tembakan	inject, shoot
plug	wall socket, wall plug, electric outlet, electrical outlet, outlet, electric receptacle
dewan	anteroom, antechamber, entrance hall, hall, foyer, lobby, vestibule
cong	eggplant, aubergine, mad apple
panti	house
bercita-cita	desire, want
beralih	switch over, switch, exchange
gumawo	Gomawo
musang	Waste
zodiak	zodiac
fuwa	Fuwa
pacak	Pacak
cuba	Cuba
penelepon	Caller
keratin	Keratin.
objection	Objection
tsum	Tsum
[musik	[music
buyung	jug
radian	radian, rad
jambul	tuft
bajing	squirrel
mengetuk	knock, belt, rap, whack, whang
gemuruh	skittish, flighty, spooky, nervous
taburan	distribution, dispersion
aromatik	aromatic
arteri	arterial
durhaka	insubordinate
fantasi	fantasy, fantasize, fantasise
dewa-dewa	immortal
coret-coret	scratches
sumsum	marrow, bone marrow
estimasi	estimate, estimation
terdepan	foremost, frontmost
haris	guard
kepiting	crab, crabmeat
porsi	helping, portion, serving
pengisi	makeweight, filler
fosfat	phosphate
pertengkaran	discord, discordance
menembok	brick in, brick up, brick over
tapir	tapir
menyemangati	uphold, maintain
bonyok	bad, spoiled, spoilt
kias	analogy
lepaskan	release, free, liberate
radang	angry
khalifah	caliph, calif, kaliph, kalif, khalif, khalifah
lebur	melt, disappear, evaporate
kios	booth, cubicle, stall, kiosk
molekul	molecular(a)
ngehang	Ngehang.
emina	Emina
menyalakan	light, illume, illumine, light up, illuminate
perubahan	conversion, rebirth, spiritual rebirth
silikon	silicon, si, atomic number 14
panglima	air force officer, commander
menyahut	answer, reply, respond
jitu	Snile
saksikan	determine, check, find out, see, ascertain, watch, learn
otentik	authentic, bona fide, unquestionable, veritable
berkeliling	approximately, about, close to, just about, some, roughly, more or less, around, or so
tiru	mock
pemanggil	caller, company
adang	guard, safety, safety device
ingus	mucus, mucous secretion
lentera	lantern
relief	relief
perusahaan	undertaking, project, task, labor
karung	bag
katrol	pulley, pulley-block, pulley block, block
sinonim	synonymous
altar	altar
jengking	scorpion
angguk	nod
cangkir	cup
memperkenalkan	insert, enclose, inclose, stick in, put in, introduce
sos	sauce
bingo	lotto, bingo, beano, keno
sebanding	equal, match, equalize, equalise, equate
tanduk	horn
menenggak	accept, live with, swallow
reporter	coverage, reporting, reportage
testis	testis, testicle, orchis, ball, ballock, bollock, nut, egg
kusut	tangled
wayar	cable
ambing	udder, bag
klise	platitude, cliche, banality, commonplace, bromide
melingkar	curl
alkitab	bible, christian bible, book, good book, holy scripture, holy writ, scripture, word of god, word
bonsai	bonsai
aliran	flow, stream
eminor	Eminor
aminor	Aminor
sarang	joint
ati-ati	coleus, flame nettle
gemar	fond(p), partial(p)
keuntungan	advantage, reward
berbalik	relapse, lapse, recidivate, regress, retrogress, fall back
penjara	imprison, incarcerate, lag, immure, put behind bars, jail, jug, gaol, put away, remand
khasiat	righteousness
searah	converge
cadas	rock, stone
jubah	alb
membran	membrane
tongkang	barge, flatboat, hoy, lighter
memaksakan	force, thrust
kontinu	continuous, uninterrupted
etnik	cultural, ethnic, ethnical
podium	catwalk
chinese	CHINESE
cika	Cika
3.00	3.00.
cimindi	Cimindi
jimin	Jimin
universitas	university
bangsal	ward
penerangan	lighting
basecamp	Basecamp.
jimat	amulet
akur	Accurate
tblt	Tblt.
wizards	Wizards
sekuriti	Security
hih	Hih
bulek	Bulek
putaran	Round
bersenang-senang	having fun
bula	Bula
kompak	thick
kemah	camping, encampment, bivouacking, tenting
semafor	semaphore
satuan	unit, social unit
sehati	consentaneous, consentient, unanimous
akad	contract
taksi	cab, hack, taxi, taxicab
rupa	appearance
menghentikan	break
tematik	thematic
selera	appetite, appetency, appetence
golek	roll, turn over
pengganti	replacement, replacing
kurma	date
aliansi	union, unification
kapsul	capsule
pembusukan	decay, decomposition
hisap	suck
mengunyah	chew, chewing, mastication, manduction
pangsit	won ton, wonton
memiringkan	slant, angle, weight
saba	saba
margarin	margarine, margarin, oleo, oleomargarine, marge
berbaring	accumbent, decumbent, recumbent
gamelan	gamelan
otodidak	autodidact
mengherankan	perplex, vex, stick, get, puzzle, mystify, baffle, beat, pose, bewilder, flummox, stupefy, nonplus, gravel, amaze, dumbfound
sarden	pilchard, sardine, sardina pilchardus
baki	leftover, left over(p), left(p), odd, remaining, unexpended
penggunaan	consumption, using up, expenditure
mengisahkan	tell, narrate, recount, recite
ulat	worm
pensiun	demobilize, inactivate, demobilise
pembalap	racer, race driver, automobile driver
banci	census, nose count, nosecount
menguasai	suppress, stamp down, inhibit, subdue, conquer, curb
mura	viper
rusuk	flank
analis	analyst
ukiran	carving
pegas	spring
opal	opal
kepadatan	consistency, consistence, eubstance, body
pertandingan	competition
terdakwa	defendant, suspect
bandara	airport, airdrome, aerodrome, drome
bohlam	light bulb, lightbulb, bulb, incandescent lamp, electric light, electric-light bulb
penggorengan	frying, sauteing
sayuran	vegetable, veggie, veg
desis	boo, hoot, bronx cheer, hiss, raspberry, razzing, razz, snort, bird
ambisi	ambitious
etis	ethical
saham	contribution, part, share
iler	saliva, spit, spittle
meminjam	assume, acquire, adopt, take on, take
tangen	tangent, tan
penolong	adjunct, assistant
empang	dam, dike, dyke
kronik	chronic
modul	module
magnetik	magnetic, magnetized, magnetised
filsuf	philosopher
menyampah	disgusting, disgustful, distasteful, foul, loathly, loathsome, repellent, repellant, repelling, revolting, skanky, wicked, yucky
skuter	motor scooter, scooter
takson	taxonomic group, taxonomic category, taxon
memperbaiki	refurbish, renovate, freshen up
meneliti	sharpen, heighten
kopal	copal
kismis	raisin
dadu	pink, pinkish
penentuan	determination, finding
kar	horse cart, horse-cart
blus	blouse
asrama	dormitory, dorm, residence hall, hall, student residence
papar	flat, level, plane
bernapas	able
ultrasonik	supersonic, ultrasonic
ayem	calm
berdedikasi	dedicated
perbandingan	relative, comparative
pembeli	taker
berbaur	dissolve, resolve, break up
penyesuaian	reconciliation, balancing
racikan	piece, slice
identitas	identity, personal identity, individuality
tertikam	pierce, thrust
kaedah	process, physical process
percakapan	dialogue, dialog
mencerminkan	eloquent, facile, fluent, silver, silver-tongued, smooth-spoken
taat	compliant
nyaring	raucous, strident
loreng	band, banding, stria, striation
colok	joss stick
instrumental	instrumental
berdansa	dance, trip the light fantastic, trip the light fantastic toe
joli-joli	yawl, dandy
majikan	boss, hirer
tumpah	spill, spillage, release
kudeta	coup d'etat, coup, putsch, takeover
ekspor	export
bungaku	my flower
lihai	backstair, backstairs, furtive
berkuda	horse racing
mengamati	note, observe, mention, remark
jabatan	position, post, berth, office, spot, billet, place, situation
berlian	diamond
pedagang	businessman, man of affairs
destinasi	destination, terminus
serikat	alliance, coalition, alignment, alinement
emping	snowflake, flake
hospital	hospital, infirmary
penjuru	corner, street corner, turning point
kura	tortoise
hipnotis	hypnotic
jajanan	tuck
pencetak	printer, printing machine
kocek	pocket
marcelino	Marcelino
document	Document
riang	Cheerfulness
aspal	bitumen
biola	violin, fiddle
hadapan	following, next
mengabulkan	concede, yield, grant
vetsin	monosodium glutamate, msg
azam	resoluteness, firmness, firmness of purpose, resolve, resolution
teologi	theology
pujian	compliment, congratulate
murahan	abject, low, low-down, miserable, scummy, scurvy
jilid	binding, book binding, cover, back
menimpa	hit, smash, smasher, strike, bang
ekologi	ecological, ecologic, bionomical, bionomic
profil	color, colour
merebus	decoct
pemilihan	choice, selection, option, pick
sepertiga	one-third, third, tierce
seenaknya	at will
johan	achiever, winner, success, succeeder
tauhid	monotheism
region	region
menyuntik	inject, shoot
infeksi	infect, taint
polo	polo
kelainan	variation, variance
kontras	contrast
lenting	ring, peal
terdaftar	read, register, show, record
makam	grave, tomb
nafkah	sustenance, sustentation, sustainment, maintenance, upkeep
majelis	forum, assembly, meeting place
bilik	bedroom, sleeping room, sleeping accommodation, chamber, bedchamber
tambak	causeway
pengunjung	caller, company
tinta	ink
berbau	fetid, foetid, foul, foul-smelling, funky, noisome, smelly, stinking, ill-scented
artikel	article
bolos	escape, flight
menyebabkan	causal agent, cause, causal agency
multimedia	multimedia, multimedia system
bando	headband
penyiar	broadcaster, spreader
linear	linear, one-dimensional
segan	fearful, timorous, trepid
kekuningan	yellow, yellowish, xanthous
sengit	heavy
pijat	bug
merdu	beautiful
lestari	ageless, aeonian, eonian, eternal, everlasting, perpetual, unending, unceasing
zon	zonal
mualaf	publication, publishing
komisi	deputation, commission, delegation, delegacy, mission
keadilan	justice
bintik	blot, smear, smirch, spot, stain
apabila	moment
pawai	procession
peliharaan	captive
mayor	major
barisan	align, array
ritualnya	ritual
mendaftar	read, register, show, record
berpaling	switch, switching, shift
menjelma	transform, transmute, metamorphose
chatkoo	Chatkoo
gregetan	annoyed
rakit	raft
kendaraan	vehicle
kesusahan	poisoning
mengering	dry, dry out
variasi	change, alter, vary
berulang-ulang	recur, repeat
raba	estimate, gauge, approximate, guess, judge
merit	merit, virtue
meronce	rape, spoil, despoil, violate, plunder
idaman	hanker, long, yearn
jamu	herb
penghilang	remover
pemanggilan	call
rimba	babbler, cackler
terbukti	prove, demonstrate, establish, show, shew
tunjangan	subsidy
rumbai	fringe
bacok	chop, hack
ahem	hem, ahem
hujan-hujan	rain tree, saman, monkeypod, monkey pod, zaman, zamang, albizia saman
pencernaan	digestive
kembung	hyperbolic, inflated
teratai	lotus, indian lotus, sacred lotus, nelumbo nucifera
menghubungkan	strap
terbelah	break, wear, wear out, bust, fall apart
pendengar	hearer, listener, auditor, attender
saudagar	businessman, man of affairs
petang	afternoon
revolver	gun
genetika	genetics, genetic science
duta	ambassadorial
menoreh	slit
ludes	finished
timun	cucumber, cuke
delima	pomegranate
puing	laying waste, ruin, ruining, ruination, wrecking
banding	compare
mendidih	seethe, roll
keder	afraid(p)
ester	ester
lecet	rub, fray, fret, chafe, scratch
dicurigai	distrust, mistrust, suspect
letih	tire, wear upon, tire out, wear, weary, jade, wear out, outwear, wear down, fag out, fag, fatigue
pembersih	cleansing agent, cleanser, cleaner
justeru	attendant, consequent, accompanying, concomitant, incidental, ensuant, resultant, sequent
getol	diligent
bingit	uncomfortable
muak	tire, pall, weary, fatigue, jade
daratan	terrestrial
elpiji	liquefied petroleum gas, bottled gas
menghidupi	treat, care for
notasi	notation, notational system
